geoid,county_name,state_abbr,days_above_90_today,days_above_90_30yrs,change_days_above_90,days_above_100_today,days_above_100_30yrs,change_days_above_100,heatbin_125_today,heatbin_125_30yrs
12021,Collier,fl,187,204,17,97,126,29,0.34,1.33
12087,Monroe,fl,190,209,19,94,126,32,0.27,0.97
12115,Sarasota,fl,172,188,16,79,112,33,0.12,0.33
12015,Charlotte,fl,174,190,16,79,111,32,0.14,0.71
48007,Aransas,tx,147,163,16,77,104,27,0.09,0.29
12103,Pinellas,fl,156,170,14,74,104,30,0.48,2.13
12071,Lee,fl,177,194,17,77,112,35,0.27,1.06
12081,Manatee,fl,165,182,17,70,106,36,0.12,0.47
48061,Cameron,tx,174,190,16,94,121,27,0.16,0.41
48489,Willacy,tx,173,190,17,93,119,26,0.14,0.38
6025,Imperial,ca,162,174,12,102,116,14,0.29,1.42
4027,Yuma,az,160,172,12,98,111,13,0.58,2.97
48261,Kenedy,tx,173,189,16,96,122,26,0.27,0.48
12051,Hendry,fl,184,201,17,83,118,35,0.23,0.86
12101,Pasco,fl,168,183,15,80,110,30,0.48,2.13
48355,Nueces,tx,152,168,16,73,102,29,0.13,0.36
12053,Hernando,fl,168,183,15,81,110,29,0.69,2.69
48071,Chambers,tx,142,157,15,77,103,26,0.34,1.54
48057,Calhoun,tx,147,163,16,72,101,29,0.12,0.49
48215,Hidalgo,tx,181,197,16,101,126,25,0.18,0.42
48273,Kleberg,tx,168,185,17,91,117,26,0.22,0.52
4012,La Paz,az,151,163,12,87,103,16,0.65,2.77
48039,Brazoria,tx,143,159,16,75,102,27,0.93,4.68
48391,Refugio,tx,152,169,17,75,103,28,0.12,0.42
22023,Cameron,la,135,149,14,66,93,27,0.26,0.99
48321,Matagorda,tx,147,163,16,79,105,26,0.77,4
48409,San Patricio,tx,150,166,16,69,99,30,0.13,0.27
48245,Jefferson,tx,138,154,16,68,96,28,0.19,0.67
48167,Galveston,tx,133,149,16,63,92,29,0.24,0.88
48047,Brooks,tx,177,193,16,104,128,24,0.29,0.54
48469,Victoria,tx,155,171,16,82,108,26,0.24,0.73
48199,Hardin,tx,140,157,17,76,101,25,0.28,1.21
12057,Hillsborough,fl,169,185,16,73,107,34,0.09,0.36
12043,Glades,fl,177,194,17,73,109,36,0.08,0.32
48247,Jim Hogg,tx,172,188,16,96,119,23,0.11,0.3
48479,Webb,tx,170,185,15,94,115,21,0.21,0.33
48249,Jim Wells,tx,167,183,16,92,116,24,0.19,0.52
48297,Live Oak,tx,163,178,15,89,113,24,0.17,0.54
4021,Pinal,az,151,162,11,83,99,16,0.27,1
4013,Maricopa,az,151,162,11,83,100,17,0.46,2.13
48015,Austin,tx,148,164,16,77,104,27,0.36,1.14
48339,Montgomery,tx,142,159,17,75,101,26,0.21,0.85
48157,Fort Bend,tx,147,164,17,74,102,28,0.27,0.72
48505,Zapata,tx,183,196,13,109,130,21,0.13,0.4
48427,Starr,tx,185,200,15,109,131,22,0.13,0.4
48131,Duval,tx,168,184,16,91,115,24,0.12,0.33
48175,Goliad,tx,161,177,16,83,110,27,0.16,0.45
48291,Liberty,tx,143,159,16,79,104,25,0.38,1.46
48123,DeWitt,tx,154,170,16,79,105,26,0.25,0.73
48089,Colorado,tx,151,167,16,78,105,27,0.34,1.12
48473,Waller,tx,144,161,17,75,102,27,0.31,0.8
48457,Tyler,tx,136,153,17,73,98,25,0.37,1.38
22039,Evangeline,la,143,158,15,73,99,26,0.4,1.85
48481,Wharton,tx,150,167,17,73,103,30,0.28,0.91
48239,Jackson,tx,149,166,17,72,101,29,0.23,0.62
12055,Highlands,fl,173,190,17,72,106,34,0.09,0.32
12049,Hardee,fl,172,189,17,71,105,34,0.06,0.23
48201,Harris,tx,142,159,17,69,98,29,0.36,1.08
12027,DeSoto,fl,175,194,19,69,106,37,0.12,0.32
22019,Calcasieu,la,135,152,17,63,91,28,0.25,0.96
12129,Wakulla,fl,139,155,16,62,94,32,0.16,0.81
48361,Orange,tx,133,151,18,61,90,29,0.15,0.6
48311,McMullen,tx,167,182,15,95,117,22,0.12,0.33
48283,La Salle,tx,166,181,15,94,116,22,0.14,0.33
48323,Maverick,tx,158,173,15,91,111,20,0.18,0.25
48507,Zavala,tx,159,175,16,88,109,21,0.22,0.28
48025,Bee,tx,157,173,16,79,105,26,0.09,0.26
48477,Washington,tx,142,159,17,74,100,26,0.24,0.72
48285,Lavaca,tx,148,165,17,73,100,27,0.24,0.64
48241,Jasper,tx,136,153,17,72,97,25,0.4,1.53
48373,Polk,tx,136,153,17,72,97,25,0.32,1.23
48455,Trinity,tx,135,152,17,71,96,25,0.34,1.52
48185,Grimes,tx,139,156,17,71,97,26,0.23,0.96
48407,San Jacinto,tx,136,153,17,70,96,26,0.2,1.11
48351,Newton,tx,134,151,17,67,93,26,0.37,1.48
22097,St. Landry,la,140,156,16,66,94,28,0.4,1.84
12105,Polk,fl,167,185,18,66,100,34,0.06,0.21
22011,Beauregard,la,136,152,16,65,92,27,0.33,1.3
22001,Acadia,la,138,154,16,64,92,28,0.37,1.7
22045,Iberia,la,133,148,15,56,85,29,0.17,0.62
48127,Dimmit,tx,167,182,15,97,117,20,0.14,0.23
48163,Frio,tx,158,173,15,84,107,23,0.21,0.19
48041,Brazos,tx,138,155,17,68,95,27,0.23,0.78
22003,Allen,la,139,155,16,68,95,27,0.33,1.57
22079,Rapides,la,134,150,16,67,92,25,0.41,1.63
48005,Angelina,tx,132,149,17,67,93,26,0.38,1.42
48051,Burleson,tx,136,153,17,67,94,27,0.13,0.52
48347,Nacogdoches,tx,128,145,17,66,91,25,0.28,1.44
48471,Walker,tx,134,151,17,66,93,27,0.18,1.03
12097,Osceola,fl,164,181,17,64,97,33,0.09,0.3
22053,Jefferson Davis,la,137,153,16,63,92,29,0.27,1.21
12017,Citrus,fl,156,172,16,63,95,32,0.67,2.46
22055,Lafayette,la,134,150,16,56,86,30,0.19,0.93
22113,Vermilion,la,131,148,17,55,85,30,0.23,1.13
22103,St. Tammany,la,135,150,15,55,85,30,0.08,0.35
12037,Franklin,fl,132,146,14,52,84,32,0.05,0.21
48313,Madison,tx,139,156,17,74,99,25,0.28,1.18
48493,Wilson,tx,148,164,16,72,97,25,0.14,0.37
48149,Fayette,tx,143,160,17,70,96,26,0.18,0.51
48021,Bastrop,tx,140,157,17,68,94,26,0.16,0.51
48405,San Augustine,tx,130,146,16,67,92,25,0.39,1.46
48225,Houston,tx,130,148,18,66,93,27,0.22,1.27
48463,Uvalde,tx,141,158,17,65,90,25,0.22,0.28
48365,Panola,tx,126,143,17,64,89,25,0.5,1.68
22043,Grant,la,131,147,16,64,89,25,0.33,1.43
48403,Sabine,tx,129,145,16,64,89,25,0.4,1.4
48465,Val Verde,tx,139,155,16,62,86,24,0.05,0.14
22085,Sabine,la,126,142,16,62,86,24,0.36,1.43
48203,Harrison,tx,123,139,16,61,86,25,0.28,1.47
22115,Vernon,la,130,147,17,61,87,26,0.36,1.58
12085,Martin,fl,164,180,16,60,96,36,0.05,0.26
12123,Taylor,fl,140,157,17,57,89,32,0.1,0.49
22105,Tangipahoa,la,136,152,16,56,86,30,0.07,0.33
22099,St. Martin,la,134,150,16,55,84,29,0.17,0.83
22095,St. John the Baptist,la,136,152,16,54,86,32,0.1,0.43
22047,Iberville,la,134,151,17,51,82,31,0.17,0.64
28047,Harrison,ms,124,139,15,44,74,30,0.07,0.32
48013,Atascosa,tx,158,173,15,83,107,24,0.13,0.26
48255,Karnes,tx,154,169,15,77,102,25,0.14,0.37
22069,Natchitoches,la,131,147,16,67,91,24,0.47,1.71
48419,Shelby,tx,128,144,16,67,91,24,0.49,1.68
48177,Gonzales,tx,143,160,17,66,92,26,0.1,0.25
48395,Robertson,tx,134,151,17,66,93,27,0.16,0.83
48315,Marion,tx,124,141,17,64,89,25,0.28,1.76
48055,Caldwell,tx,139,156,17,64,90,26,0.08,0.22
48287,Lee,tx,137,154,17,64,91,27,0.18,0.51
48331,Milam,tx,134,151,17,64,91,27,0.16,0.56
22073,Ouachita,la,126,141,15,63,85,22,0.42,1.49
22049,Jackson,la,126,141,15,63,86,23,0.39,1.53
22081,Red River,la,126,141,15,63,87,24,0.42,1.63
22031,De Soto,la,126,141,15,63,88,25,0.53,1.77
48183,Gregg,tx,125,142,17,63,89,26,0.19,1.22
48001,Anderson,tx,127,145,18,63,90,27,0.19,1.84
48293,Limestone,tx,130,147,17,63,90,27,0.12,0.84
12119,Sumter,fl,158,175,17,63,94,31,0.11,0.26
22009,Avoyelles,la,134,150,16,62,88,26,0.41,1.52
48029,Bexar,tx,140,157,17,62,88,26,0.07,0.16
48187,Guadalupe,tx,139,156,17,62,88,26,0.07,0.18
12093,Okeechobee,fl,168,186,18,62,98,36,0.07,0.29
22015,Bossier,la,124,139,15,61,85,24,0.31,1.62
22017,Caddo,la,124,140,16,61,86,25,0.39,1.69
48271,Kinney,tx,139,156,17,61,87,26,0.18,0.25
12095,Orange,fl,158,176,18,61,93,32,0.07,0.22
48401,Rusk,tx,123,140,17,59,86,27,0.3,1.43
48073,Cherokee,tx,124,142,18,58,86,28,0.3,1.41
48423,Smith,tx,123,141,18,57,85,28,0.26,1.35
12111,St. Lucie,fl,160,177,17,57,92,35,0.07,0.27
12099,Palm Beach,fl,166,185,19,55,94,39,0.08,0.29
12011,Broward,fl,170,189,19,55,95,40,0.09,0.29
22117,Washington,la,131,147,16,54,82,28,0.12,0.55
22077,Pointe Coupee,la,134,150,16,53,82,29,0.27,1
22121,West Baton Rouge,la,134,151,17,52,82,30,0.12,0.54
22063,Livingston,la,135,151,16,52,83,31,0.09,0.39
12067,Lafayette,fl,139,157,18,52,83,31,0.08,0.31
22051,Jefferson,la,134,150,16,52,84,32,0.07,0.33
22093,St. James,la,137,153,16,52,85,33,0.16,0.63
22005,Ascension,la,136,152,16,51,82,31,0.17,0.66
22071,Orleans,la,134,150,16,51,83,32,0.07,0.33
22089,St. Charles,la,134,151,17,51,83,32,0.06,0.39
22033,East Baton Rouge,la,134,150,16,50,80,30,0.14,0.46
12086,Miami-Dade,fl,167,186,19,50,91,41,0.14,0.79
22087,St. Bernard,la,133,149,16,48,81,33,0.06,0.27
28109,Pearl River,ms,128,145,17,47,76,29,0.11,0.52
22075,Plaquemines,la,130,145,15,46,79,33,0.07,0.27
48343,Morris,tx,124,141,17,66,90,24,0.32,1.89
48449,Titus,tx,123,139,16,65,89,24,0.32,1.82
48067,Cass,tx,123,139,16,64,88,24,0.33,1.93
48459,Upshur,tx,124,141,17,64,89,25,0.28,1.73
48161,Freestone,tx,130,147,17,64,91,27,0.18,1.79
48325,Medina,tx,143,160,17,63,89,26,0.16,0.16
22061,Lincoln,la,124,139,15,62,85,23,0.38,1.51
22119,Webster,la,124,139,15,62,86,24,0.38,1.73
48213,Henderson,tx,125,142,17,62,89,27,0.19,1.84
22059,LaSalle,la,129,145,16,61,85,24,0.39,1.43
22013,Bienville,la,124,139,15,61,85,24,0.39,1.57
48453,Travis,tx,134,150,16,61,86,25,0.09,0.22
48145,Falls,tx,131,148,17,61,89,28,0.14,0.57
5073,Lafayette,ar,119,135,16,60,83,23,0.31,1.64
48309,McLennan,tx,127,143,16,60,86,26,0.11,0.41
48349,Navarro,tx,125,142,17,59,86,27,0.18,1.78
48209,Hays,tx,133,149,16,58,83,25,0.11,0.21
12083,Marion,fl,153,169,16,58,89,31,0.13,0.36
12069,Lake,fl,155,173,18,58,90,32,0.11,0.26
12117,Seminole,fl,154,171,17,57,88,31,0.06,0.16
28125,Sharkey,ms,122,136,14,56,79,23,0.43,1.42
12107,Putnam,fl,144,160,16,56,85,29,0.11,0.37
28091,Marion,ms,130,145,15,55,82,27,0.13,0.77
12041,Gilchrist,fl,144,161,17,55,86,31,0.06,0.21
12121,Suwannee,fl,142,160,18,55,86,31,0.08,0.31
28055,Issaquena,ms,121,136,15,54,77,23,0.47,1.51
12075,Levy,fl,146,163,17,54,86,32,0.35,1.09
22125,West Feliciana,la,132,148,16,52,80,28,0.27,0.91
28147,Walthall,ms,127,143,16,50,76,26,0.12,0.58
12023,Columbia,fl,138,156,18,50,81,31,0.07,0.26
13253,Seminole,ga,132,150,18,50,81,31,0.15,0.59
13087,Decatur,ga,133,151,18,50,81,31,0.14,0.61
22007,Assumption,la,136,152,16,50,82,32,0.17,0.67
28029,Copiah,ms,124,140,16,49,75,26,0.31,0.79
12029,Dixie,fl,139,156,17,49,82,33,0.14,0.63
22037,East Feliciana,la,128,144,16,48,76,28,0.24,0.74
28005,Amite,ms,125,141,16,47,74,27,0.26,0.75
28113,Pike,ms,124,140,16,46,73,27,0.08,0.43
13075,Cook,ga,127,145,18,46,74,28,0.06,0.23
22109,Terrebonne,la,132,149,17,45,78,33,0.16,0.75
22057,Lafourche,la,133,149,16,45,78,33,0.14,0.54
28045,Hancock,ms,123,139,16,43,73,30,0.06,0.32
28059,Jackson,ms,122,137,15,40,70,30,0.06,0.24
12033,Escambia,fl,119,132,13,38,67,29,0.04,0.13
48063,Camp,tx,123,139,16,64,89,25,0.31,1.8
22027,Claiborne,la,123,138,15,63,86,23,0.53,2
22111,Union,la,124,139,15,62,84,22,0.4,1.63
48037,Bowie,tx,119,134,15,62,85,23,0.34,2.16
22021,Caldwell,la,126,142,16,61,84,23,0.52,1.51
48251,Johnson,tx,123,139,16,61,85,24,0.11,0.46
48499,Wood,tx,121,138,17,61,87,26,0.19,1.61
22041,Franklin,la,127,142,15,60,83,23,0.51,1.58
22067,Morehouse,la,125,140,15,60,83,23,0.41,1.72
48139,Ellis,tx,124,140,16,60,86,26,0.15,0.97
48257,Kaufman,tx,122,138,16,60,86,26,0.13,1.29
5027,Columbia,ar,118,134,16,59,81,22,0.52,1.77
5091,Miller,ar,118,133,15,59,82,23,0.38,2.16
48217,Hill,tx,124,141,17,59,84,25,0.17,0.67
48467,Van Zandt,tx,121,138,17,59,85,26,0.14,1.44
5139,Union,ar,119,134,15,58,80,22,0.52,1.74
48363,Palo Pinto,tx,119,136,17,58,80,22,0.12,0.36
48221,Hood,tx,121,138,17,58,81,23,0.07,0.24
48439,Tarrant,tx,119,135,16,58,82,24,0.12,0.59
22025,Catahoula,la,128,144,16,58,83,25,0.46,1.41
48379,Rains,tx,118,135,17,58,84,26,0.16,1.32
48159,Franklin,tx,118,135,17,58,84,26,0.22,1.35
48503,Young,tx,116,133,17,57,78,21,0.09,0.24
28053,Humphreys,ms,121,136,15,57,79,22,0.38,1.37
22123,West Carroll,la,123,138,15,57,80,23,0.41,1.41
48035,Bosque,tx,123,140,17,57,81,24,0.09,0.36
48155,Foard,tx,112,128,16,56,76,20,0.07,0.27
28151,Washington,ms,118,133,15,56,78,22,0.47,1.64
5017,Chicot,ar,120,134,14,56,78,22,0.46,1.64
22035,East Carroll,la,122,136,14,56,79,23,0.44,1.49
48491,Williamson,tx,129,146,17,56,81,25,0.08,0.22
48387,Red River,tx,115,132,17,56,81,25,0.21,1.52
13049,Charlton,ga,135,152,17,56,82,26,0.16,0.59
22107,Tensas,la,127,142,15,54,79,25,0.51,1.52
48027,Bell,tx,125,142,17,54,79,25,0.11,0.39
13179,Liberty,ga,125,142,17,52,78,26,0.23,0.76
48049,Brown,tx,120,137,17,51,74,23,0.09,0.17
28037,Franklin,ms,126,142,16,51,77,26,0.25,0.83
13201,Miller,ga,132,150,18,51,80,29,0.15,0.61
12001,Alachua,fl,143,160,17,51,82,31,0.08,0.26
28077,Lawrence,ms,125,140,15,50,76,26,0.14,0.62
28085,Lincoln,ms,123,139,16,48,74,26,0.16,0.58
28157,Wilkinson,ms,128,145,17,47,75,28,0.29,0.92
13101,Echols,ga,131,149,18,47,76,29,0.07,0.19
4015,Mohave,az,114,127,13,45,58,13,0.69,2.44
13099,Early,ga,126,145,19,45,73,28,0.13,0.44
13027,Brooks,ga,129,147,18,45,74,29,0.04,0.16
13185,Lowndes,ga,129,147,18,45,75,30,0.09,0.16
12073,Leon,fl,131,150,19,45,77,32,0.07,0.29
13127,Glynn,ga,117,133,16,44,69,25,0.09,0.37
13131,Grady,ga,129,147,18,44,74,30,0.11,0.49
12061,Indian River,fl,151,170,19,44,80,36,0.08,0.3
28131,Stone,ms,125,142,17,43,70,27,0.07,0.3
13191,McIntosh,ga,114,129,15,41,65,24,0.13,0.45
12077,Liberty,fl,129,147,18,41,73,32,0.04,0.16
12013,Calhoun,fl,129,148,19,41,73,32,0.04,0.17
32003,Clark,nv,117,129,12,39,58,19,0.69,2.44
22101,St. Mary,la,125,143,18,37,69,32,0.3,1.32
5133,Sevier,ar,115,130,15,60,81,21,0.37,1.89
48425,Somervell,tx,124,141,17,60,83,23,0.07,0.29
48113,Dallas,tx,121,137,16,60,84,24,0.12,0.97
48231,Hunt,tx,119,135,16,60,85,25,0.2,1.37
48009,Archer,tx,114,130,16,58,78,20,0.06,0.26
5081,Little River,ar,116,132,16,58,81,23,0.26,1.44
40023,Choctaw,ok,114,130,16,58,82,24,0.26,1.59
48085,Collin,tx,118,134,16,58,83,25,0.12,0.86
48397,Rockwall,tx,119,135,16,58,84,26,0.12,0.92
48023,Baylor,tx,112,128,16,56,76,20,0.06,0.24
48277,Lamar,tx,114,129,15,56,80,24,0.22,1.4
48119,Delta,tx,116,132,16,56,82,26,0.13,1.05
5103,Ouachita,ar,115,130,15,55,76,21,0.32,1.49
48275,Knox,tx,115,132,17,55,76,21,0.02,0.18
48077,Clay,tx,112,128,16,55,76,21,0.17,0.53
40029,Coal,ok,107,123,16,55,77,22,0.46,1.93
48237,Jack,tx,114,131,17,55,77,22,0.13,0.46
48223,Hopkins,tx,117,134,17,55,82,27,0.17,1.34
48487,Wilbarger,tx,111,127,16,54,74,20,0.15,0.29
48447,Throckmorton,tx,114,131,17,54,75,21,0.09,0.23
28133,Sunflower,ms,116,131,15,54,76,22,0.32,1.5
22083,Richland,la,122,137,15,54,77,23,0.45,1.47
28149,Warren,ms,125,141,16,54,78,24,0.43,1.31
48299,Llano,tx,127,144,17,54,79,25,0.04,0.13
48147,Fannin,tx,112,129,17,54,79,25,0.23,1.21
5003,Ashley,ar,118,133,15,53,76,23,0.39,1.62
48367,Parker,tx,115,131,16,53,77,24,0.12,0.36
48091,Comal,tx,130,147,17,53,79,26,0.08,0.17
13183,Long,ga,126,143,17,52,78,26,0.23,0.61
5011,Bradley,ar,114,129,15,51,73,22,0.31,1.56
13305,Wayne,ga,125,143,18,51,76,25,0.16,0.46
13031,Bulloch,ga,122,140,18,51,76,25,0.32,1.07
48429,Stephens,tx,115,132,17,50,73,23,0.08,0.2
48207,Haskell,tx,113,130,17,50,73,23,0.06,0.19
28021,Claiborne,ms,123,139,16,50,75,25,0.47,1.42
13081,Crisp,ga,124,142,18,50,76,26,0.25,0.7
13095,Dougherty,ga,127,145,18,50,78,28,0.09,0.5
12125,Union,fl,138,155,17,50,79,29,0.06,0.25
28163,Yazoo,ms,118,133,15,49,73,24,0.36,1.08
48053,Burnet,tx,124,141,17,49,74,25,0.07,0.13
28063,Jefferson,ms,124,140,16,49,75,26,0.33,1.04
13299,Ware,ga,128,146,18,49,77,28,0.12,0.48
13007,Baker,ga,130,148,18,49,78,29,0.11,0.54
48099,Coryell,tx,121,138,17,48,74,26,0.06,0.13
12047,Hamilton,fl,134,153,19,48,78,30,0.04,0.18
12079,Madison,fl,135,154,19,48,80,32,0.03,0.12
13177,Lee,ga,124,143,19,47,75,28,0.17,0.58
48417,Shackelford,tx,113,130,17,46,69,23,0.06,0.17
28089,Madison,ms,118,133,15,46,70,24,0.28,0.79
28049,Hinds,ms,119,135,16,46,71,25,0.31,0.93
13069,Coffee,ga,125,142,17,46,73,27,0.08,0.27
28111,Perry,ms,127,143,16,46,73,27,0.11,0.27
28065,Jefferson Davis,ms,121,138,17,45,71,26,0.11,0.64
13205,Mitchell,ga,126,145,19,45,73,28,0.12,0.54
48101,Cottle,tx,106,123,17,44,65,21,0.04,0.19
48433,Stonewall,tx,110,127,17,44,67,23,0.06,0.18
48253,Jones,tx,112,130,18,44,68,24,0.03,0.16
28041,Greene,ms,125,141,16,44,71,27,0.08,0.19
28073,Lamar,ms,125,141,16,44,71,27,0.08,0.39
12009,Brevard,fl,146,163,17,44,76,32,0.09,0.3
28127,Simpson,ms,117,133,16,43,67,24,0.2,0.61
48281,Lampasas,tx,118,135,17,43,68,25,0.07,0.14
48411,San Saba,tx,117,135,18,42,67,25,0.04,0.08
48193,Hamilton,tx,114,132,18,42,68,26,0.09,0.17
13275,Thomas,ga,128,147,19,42,72,30,0.12,0.34
12063,Jackson,fl,127,145,18,41,71,30,0.11,0.42
12039,Gadsden,fl,127,146,19,41,72,31,0.03,0.13
12065,Jefferson,fl,128,147,19,41,73,32,0.12,0.67
13277,Tift,ga,119,138,19,40,66,26,0.03,0.19
6065,Riverside,ca,107,123,16,39,55,16,0.6,2.6
48019,Bandera,tx,122,141,19,38,65,27,0.02,0.06
12133,Washington,fl,127,146,19,35,65,30,0.05,0.11
1003,Baldwin,al,120,135,15,34,64,30,0.07,0.24
12113,Santa Rosa,fl,117,132,15,33,62,29,0.03,0.14
12005,Bay,fl,122,139,17,33,64,31,0.06,0.17
48497,Wise,tx,116,132,16,58,80,22,0.19,0.7
40089,McCurtain,ok,113,129,16,58,81,23,0.28,1.72
48121,Denton,tx,118,134,16,58,81,23,0.11,0.56
48485,Wichita,tx,112,128,16,57,77,20,0.12,0.31
40005,Atoka,ok,110,125,15,57,79,22,0.46,1.93
40033,Cotton,ok,110,126,16,56,76,20,0.14,0.39
5099,Nevada,ar,115,130,15,56,78,22,0.31,1.81
40019,Carter,ok,110,126,16,55,77,22,0.18,0.94
5057,Hempstead,ar,112,128,16,54,76,22,0.32,1.75
40069,Johnston,ok,109,125,16,54,76,22,0.22,1.09
40127,Pushmataha,ok,107,123,16,54,76,22,0.34,1.72
40141,Tillman,ok,108,123,15,53,73,20,0.11,0.32
28083,Leflore,ms,116,131,15,53,75,22,0.36,1.44
40077,Latimer,ok,103,119,16,52,73,21,0.46,2.05
5061,Howard,ar,109,125,16,52,74,22,0.33,1.61
28011,Bolivar,ms,113,128,15,52,74,22,0.29,1.62
5013,Calhoun,ar,114,130,16,52,75,23,0.26,1.39
5041,Desha,ar,114,129,15,51,74,23,0.29,1.62
48097,Cooke,tx,110,126,16,51,74,23,0.11,0.58
13043,Candler,ga,125,142,17,51,77,26,0.18,0.57
13229,Pierce,ga,129,146,17,51,78,27,0.09,0.39
40065,Jackson,ok,107,123,16,50,71,21,0.07,0.27
40121,Pittsburg,ok,102,118,16,50,72,22,0.44,1.55
22029,Concordia,la,127,143,16,50,77,27,0.32,1.2
40057,Harmon,ok,107,123,16,49,69,20,0.06,0.27
5105,Perry,ar,103,118,15,49,69,20,0.44,1.53
5039,Dallas,ar,109,125,16,49,70,21,0.44,1.72
48197,Hardeman,tx,107,123,16,49,70,21,0.04,0.27
5025,Cleveland,ar,111,127,16,48,70,22,0.38,1.48
5109,Pike,ar,102,118,16,47,68,21,0.32,1.81
5125,Saline,ar,105,120,15,47,68,21,0.33,1.37
5043,Drew,ar,113,128,15,47,71,24,0.32,1.53
13093,Dooly,ga,121,139,18,46,73,27,0.26,0.7
12019,Clay,fl,132,149,17,46,73,27,0.13,0.43
5097,Montgomery,ar,98,113,15,45,66,21,0.23,1.28
28121,Rankin,ms,118,134,16,45,69,24,0.2,0.6
1023,Choctaw,al,121,137,16,45,70,25,0.18,0.51
13109,Evans,ga,119,136,17,45,70,25,0.24,0.63
13025,Brantley,ga,124,142,18,45,71,26,0.16,0.53
13065,Clinch,ga,127,144,17,45,72,27,0.11,0.33
48269,King,tx,109,126,17,44,66,22,0.01,0.14
28079,Leake,ms,113,129,16,44,67,23,0.21,0.58
28129,Smith,ms,117,133,16,44,68,24,0.11,0.44
13103,Effingham,ga,118,135,17,44,70,26,0.24,0.77
13315,Wilcox,ga,120,138,18,44,70,26,0.09,0.34
13235,Pulaski,ga,119,137,18,44,70,26,0.08,0.31
13091,Dodge,ga,119,137,18,44,70,26,0.16,0.35
48031,Blanco,tx,121,139,18,44,70,26,0.05,0.09
13155,Irwin,ga,121,139,18,44,71,27,0.06,0.27
12007,Bradford,fl,133,150,17,44,72,28,0.07,0.26
48377,Presidio,tx,115,134,19,43,57,14,0.02,0.07
28069,Kemper,ms,113,129,16,43,66,23,0.09,0.46
28123,Scott,ms,116,132,16,43,66,23,0.12,0.4
28075,Lauderdale,ms,116,133,17,43,67,24,0.09,0.37
48093,Comanche,tx,113,130,17,43,68,25,0.08,0.14
13001,Appling,ga,121,139,18,43,69,26,0.14,0.36
1129,Washington,al,125,142,17,43,69,26,0.08,0.29
28153,Wayne,ms,122,139,17,43,69,26,0.07,0.32
13003,Atkinson,ga,125,143,18,43,70,27,0.08,0.21
12003,Baker,fl,130,147,17,43,71,28,0.06,0.23
13173,Lanier,ga,126,144,18,43,71,28,0.11,0.21
13029,Bryan,ga,116,133,17,42,67,25,0.23,0.76
28067,Jones,ms,120,136,16,42,67,25,0.07,0.37
13019,Berrien,ga,125,144,19,42,70,28,0.09,0.22
5113,Polk,ar,94,111,17,41,62,21,0.26,1.46
28003,Alcorn,ms,99,116,17,41,62,21,0.22,1.2
47047,Fayette,tn,98,115,17,41,63,22,0.26,1.59
4019,Pima,az,130,143,13,41,63,22,0.18,1.43
45053,Jasper,sc,114,132,18,41,66,25,0.21,0.68
12031,Duval,fl,125,142,17,41,68,27,0.09,0.37
13321,Worth,ga,120,138,18,41,68,27,0.17,0.54
28031,Covington,ms,118,135,17,40,65,25,0.07,0.35
12035,Flagler,fl,131,147,16,40,67,27,0.06,0.22
13273,Terrell,ga,119,139,20,40,67,27,0.06,0.37
28039,George,ms,123,140,17,40,67,27,0.06,0.14
13071,Colquitt,ga,123,141,18,40,67,27,0.12,0.34
48143,Erath,tx,109,126,17,39,63,24,0.09,0.18
13261,Sumter,ga,115,134,19,39,64,25,0.26,0.69
48399,Runnels,tx,116,135,19,39,64,25,0.04,0.11
48095,Concho,tx,118,137,19,39,64,25,0.03,0.08
28035,Forrest,ms,122,139,17,39,66,27,0.08,0.24
48475,Ward,tx,124,140,16,38,62,24,0.01,0.01
13287,Turner,ga,116,134,18,38,64,26,0.04,0.29
12109,St. Johns,fl,126,143,17,38,66,28,0.07,0.24
13037,Calhoun,ga,121,141,20,38,66,28,0.07,0.28
48151,Fisher,tx,109,128,19,37,61,24,0.01,0.1
48307,McCulloch,tx,115,133,18,37,62,25,0.04,0.06
1067,Henry,al,117,136,19,37,63,26,0.06,0.26
1069,Houston,al,120,138,18,37,64,27,0.12,0.42
12059,Holmes,fl,122,140,18,36,64,28,0.07,0.19
48259,Kendall,tx,116,135,19,33,59,26,0.04,0.08
48319,Mason,tx,112,131,19,32,57,25,0.04,0.05
12045,Gulf,fl,121,139,18,32,62,30,0.06,0.18
40013,Bryan,ok,111,127,16,56,79,23,0.26,1.42
40079,Le Flore,ok,106,121,15,55,76,21,0.54,2.69
5083,Logan,ar,105,120,15,54,74,20,0.65,2.83
40067,Jefferson,ok,110,126,16,54,75,21,0.21,0.55
5019,Clark,ar,110,126,16,52,73,21,0.44,1.79
5131,Sebastian,ar,102,118,16,51,71,20,0.45,2.11
40091,McIntosh,ok,101,118,17,51,72,21,0.37,1.62
40063,Hughes,ok,103,119,16,51,72,21,0.41,1.43
40085,Love,ok,108,124,16,51,73,22,0.14,0.81
40095,Marshall,ok,109,125,16,51,74,23,0.17,0.83
5029,Conway,ar,103,118,15,50,70,20,0.44,1.67
5149,Yell,ar,103,118,15,50,70,20,0.46,2.13
5127,Scott,ar,101,117,16,50,70,20,0.37,1.84
40061,Haskell,ok,101,118,17,50,71,21,0.46,1.89
40133,Seminole,ok,103,119,16,50,72,22,0.25,1.06
48337,Montague,tx,109,126,17,50,72,22,0.12,0.47
40031,Comanche,ok,104,119,15,49,69,20,0.14,0.34
5047,Franklin,ar,99,115,16,49,69,20,0.39,2.07
28019,Choctaw,ms,113,128,15,49,71,22,0.14,0.85
5033,Crawford,ar,99,115,16,48,68,20,0.23,1.48
5053,Grant,ar,107,123,16,48,69,21,0.29,1.39
5051,Garland,ar,104,119,15,48,69,21,0.3,1.51
5059,Hot Spring,ar,106,122,16,48,69,21,0.37,1.55
5079,Lincoln,ar,111,127,16,48,70,22,0.38,1.53
48181,Grayson,tx,108,125,17,48,72,24,0.11,0.68
5045,Faulkner,ar,102,118,16,47,68,21,0.3,1.37
5069,Jefferson,ar,108,123,15,47,68,21,0.36,1.43
28087,Lowndes,ms,113,129,16,47,69,22,0.13,0.53
28135,Tallahatchie,ms,109,125,16,47,69,22,0.32,1.7
28155,Webster,ms,111,127,16,47,69,22,0.12,0.84
28103,Noxubee,ms,114,129,15,47,70,23,0.12,0.59
5119,Pulaski,ar,103,119,16,46,67,21,0.29,1.29
5107,Phillips,ar,106,122,16,46,67,21,0.27,1.66
28007,Attala,ms,112,127,15,46,69,23,0.3,0.75
28025,Clay,ms,112,127,15,46,69,23,0.12,0.72
1119,Sumter,al,116,132,16,46,70,24,0.14,0.41
13165,Jenkins,ga,119,136,17,46,71,25,0.21,0.74
13175,Laurens,ga,119,136,17,46,71,25,0.14,0.36
40055,Greer,ok,103,119,16,45,65,20,0.05,0.27
5071,Johnson,ar,96,112,16,45,65,20,0.31,1.7
40135,Sequoyah,ok,97,114,17,45,66,21,0.34,1.61
13017,Ben Hill,ga,120,138,18,45,71,26,0.08,0.27
1107,Pickens,al,110,126,16,44,66,22,0.15,0.46
28043,Grenada,ms,107,123,16,44,66,22,0.29,1.49
28015,Carroll,ms,109,125,16,44,66,22,0.34,1.23
28051,Holmes,ms,112,128,16,44,67,23,0.39,1.25
13251,Screven,ga,117,135,18,44,69,25,0.29,0.96
13267,Tattnall,ga,120,138,18,44,70,26,0.24,0.63
28145,Union,ms,103,119,16,43,64,21,0.22,1.29
5145,White,ar,101,117,16,43,65,22,0.3,1.43
5111,Poinsett,ar,99,116,17,43,65,22,0.28,1.85
28081,Lee,ms,106,122,16,43,65,22,0.27,1.23
28159,Winston,ms,110,126,16,43,66,23,0.14,0.71
28023,Clarke,ms,117,134,17,43,67,24,0.14,0.46
13271,Telfair,ga,120,138,18,43,68,25,0.16,0.35
13319,Wilkinson,ga,116,134,18,43,68,25,0.16,0.44
13107,Emanuel,ga,118,136,18,43,68,25,0.14,0.46
13309,Wheeler,ga,120,138,18,43,69,26,0.13,0.34
40075,Kiowa,ok,100,115,15,42,62,20,0.12,0.32
28009,Benton,ms,99,116,17,42,63,21,0.23,1.36
47167,Tipton,tn,97,114,17,42,64,22,0.34,2.23
28061,Jasper,ms,116,132,16,42,66,24,0.14,0.46
45049,Hampton,sc,116,134,18,42,66,24,0.3,0.78
13209,Montgomery,ga,119,137,18,42,67,25,0.09,0.33
1025,Clarke,al,122,139,17,42,68,26,0.17,0.49
28001,Adams,ms,123,140,17,42,69,27,0.27,0.92
13005,Bacon,ga,122,140,18,42,69,27,0.06,0.27
28115,Pontotoc,ms,102,119,17,41,62,21,0.28,1.23
47069,Hardeman,tn,97,114,17,41,62,21,0.27,1.57
5093,Mississippi,ar,96,113,17,41,63,22,0.43,2.12
28099,Neshoba,ms,110,126,16,41,63,22,0.11,0.51
28101,Newton,ms,112,129,17,41,64,23,0.08,0.34
1131,Wilcox,al,117,135,18,41,65,24,0.11,0.41
13279,Toombs,ga,119,137,18,41,67,26,0.15,0.37
1013,Butler,al,119,137,18,41,67,26,0.07,0.33
13023,Bleckley,ga,116,134,18,41,67,26,0.07,0.27
13193,Macon,ga,116,135,19,41,67,26,0.18,0.49
47109,McNairy,tn,97,115,18,40,61,21,0.22,1.28
28139,Tippah,ms,97,114,17,40,61,21,0.23,1.22
45005,Allendale,sc,113,131,18,40,64,24,0.26,0.75
1101,Montgomery,al,113,131,18,40,64,24,0.17,0.44
48133,Eastland,tx,109,127,18,40,64,24,0.09,0.16
13243,Randolph,ga,120,139,19,40,67,27,0.12,0.39
48087,Collingsworth,tx,101,118,17,39,59,20,0.06,0.22
47075,Haywood,tn,94,112,18,39,60,21,0.22,1.51
47071,Hardin,tn,98,115,17,39,60,21,0.22,1.07
45027,Clarendon,sc,109,127,18,39,61,22,0.24,0.74
47023,Chester,tn,95,113,18,39,61,22,0.27,1.59
48075,Childress,tx,102,119,17,39,61,22,0.03,0.22
13153,Houston,ga,113,132,19,39,64,25,0.08,0.33
1035,Conecuh,al,119,138,19,39,65,26,0.04,0.25
1041,Crenshaw,al,116,135,19,39,65,26,0.12,0.32
1039,Covington,al,120,139,19,39,66,27,0.08,0.28
12127,Volusia,fl,138,155,17,39,67,28,0.07,0.23
5021,Clay,ar,92,109,17,38,59,21,0.41,2.12
13289,Twiggs,ga,111,130,19,38,62,24,0.07,0.28
13021,Bibb,ga,111,130,19,38,62,24,0.07,0.29
13039,Camden,ga,119,137,18,38,64,26,0.13,0.41
1053,Escambia,al,122,140,18,38,65,27,0.05,0.22
40039,Custer,ok,94,110,16,37,57,20,0.06,0.2
40149,Washita,ok,95,111,16,37,57,20,0.09,0.29
47077,Henderson,tn,92,110,18,37,57,20,0.16,0.98
47113,Madison,tn,93,111,18,37,58,21,0.24,1.42
28117,Prentiss,ms,97,115,18,37,58,21,0.13,0.79
45015,Berkeley,sc,107,125,18,37,60,23,0.23,0.93
1113,Russell,al,109,128,19,37,61,24,0.15,0.41
48081,Coke,tx,112,131,19,37,61,24,0.02,0.06
47039,Decatur,tn,92,111,19,36,57,21,0.17,0.98
13051,Chatham,ga,111,128,17,36,62,26,0.2,0.56
13061,Clay,ga,116,136,20,36,62,26,0.08,0.25
48191,Hall,tx,100,116,16,35,57,22,0.02,0.16
45009,Bamberg,sc,108,127,19,35,59,24,0.29,0.7
13215,Muscogee,ga,108,126,18,35,59,24,0.12,0.41
13053,Chattahoochee,ga,108,127,19,35,59,24,0.12,0.41
13249,Schley,ga,111,130,19,35,60,25,0.07,0.27
13307,Webster,ga,112,131,19,35,60,25,0.07,0.29
1045,Dale,al,115,134,19,35,60,25,0.04,0.15
12089,Nassau,fl,118,135,17,35,61,26,0.13,0.49
48389,Reeves,tx,120,137,17,34,56,22,0.02,0.03
13169,Jones,ga,106,126,20,34,57,23,0.08,0.29
1011,Bullock,al,108,127,19,34,58,24,0.17,0.43
48333,Mills,tx,111,130,19,33,59,26,0.03,0.08
1061,Geneva,al,116,135,19,33,59,26,0.07,0.19
13197,Marion,ga,105,125,20,32,55,23,0.05,0.21
45013,Beaufort,sc,106,123,17,32,56,24,0.19,0.62
48301,Loving,tx,118,135,17,31,54,23,0.01,0.02
48059,Callahan,tx,105,123,18,30,54,24,0.07,0.12
12131,Walton,fl,119,136,17,30,59,29,0.07,0.16
48451,Tom Green,tx,109,128,19,29,54,25,0.02,0.04
1097,Mobile,al,116,134,18,29,56,27,0.07,0.24
48327,Menard,tx,111,131,20,28,53,25,0.03,0.05
48443,Terrell,tx,113,131,18,25,48,23,0.01,0.03
48267,Kimble,tx,111,131,20,25,50,25,0.02,0.03
40101,Muskogee,ok,101,117,16,52,73,21,0.43,1.91
5115,Pope,ar,104,119,15,51,71,20,0.46,1.88
40107,Okfuskee,ok,101,117,16,50,71,21,0.33,1.37
40111,Okmulgee,ok,100,116,16,50,71,21,0.39,1.54
40145,Wagoner,ok,98,114,16,48,70,22,0.43,1.91
40081,Lincoln,ok,98,114,16,47,67,20,0.23,1.13
28105,Oktibbeha,ms,112,127,15,47,69,22,0.12,0.85
28119,Quitman,ms,110,125,15,47,70,23,0.29,1.76
40125,Pottawatomie,ok,99,115,16,46,67,21,0.27,0.89
40143,Tulsa,ok,96,112,16,46,67,21,0.46,1.57
40131,Rogers,ok,95,111,16,46,67,21,0.38,1.58
40123,Pontotoc,ok,101,117,16,46,67,21,0.23,0.98
40137,Stephens,ok,103,118,15,46,67,21,0.15,0.5
40097,Mayes,ok,95,112,17,46,67,21,0.4,1.62
28027,Coahoma,ms,108,124,16,46,68,22,0.24,1.63
40073,Kingfisher,ok,97,112,15,45,64,19,0.17,0.46
40049,Garvin,ok,102,118,16,45,67,22,0.16,0.58
5035,Crittenden,ar,102,118,16,44,65,21,0.34,1.96
28143,Tunica,ms,105,121,16,44,66,22,0.27,1.72
5001,Arkansas,ar,105,121,16,44,66,22,0.26,1.44
40021,Cherokee,ok,95,112,17,44,66,22,0.43,1.87
28161,Yalobusha,ms,106,122,16,44,66,22,0.24,1.43
28071,Lafayette,ms,105,121,16,44,66,22,0.22,1.48
28095,Monroe,ms,108,125,17,44,66,22,0.2,0.99
28107,Panola,ms,106,121,15,44,66,22,0.27,1.79
1063,Greene,al,113,130,17,44,67,23,0.16,0.46
40051,Grady,ok,99,115,16,43,63,20,0.26,0.63
28017,Chickasaw,ms,105,121,16,43,64,21,0.21,1.02
40035,Craig,ok,92,108,16,43,64,21,0.34,1.58
28013,Calhoun,ms,106,123,17,43,65,22,0.18,1.13
1047,Dallas,al,116,133,17,43,67,24,0.11,0.35
13161,Jeff Davis,ga,120,138,18,43,68,25,0.08,0.31
5067,Jackson,ar,97,113,16,42,63,21,0.26,1.58
5117,Prairie,ar,101,117,16,42,63,21,0.25,1.47
40115,Ottawa,ok,90,107,17,42,63,21,0.36,1.58
28033,DeSoto,ms,102,118,16,42,64,22,0.37,2.03
47157,Shelby,tn,100,116,16,42,64,22,0.34,2.23
40041,Delaware,ok,92,109,17,42,64,22,0.31,1.55
5085,Lonoke,ar,99,116,17,41,62,21,0.29,1.22
28057,Itawamba,ms,104,121,17,41,62,21,0.13,0.79
40087,McClain,ok,97,113,16,41,62,21,0.23,0.72
1125,Tuscaloosa,al,109,126,17,41,63,22,0.12,0.43
13283,Treutlen,ga,117,136,19,41,66,25,0.06,0.28
5095,Monroe,ar,100,116,16,40,61,21,0.22,1.48
5031,Craighead,ar,96,113,17,40,61,21,0.26,1.8
40015,Caddo,ok,97,113,16,40,61,21,0.15,0.36
28093,Marshall,ms,99,115,16,40,62,22,0.23,1.58
13167,Johnson,ga,114,132,18,40,65,25,0.08,0.33
21157,Marshall,ky,90,108,18,39,59,20,0.41,1.82
29069,Dunklin,mo,92,110,18,39,60,21,0.41,2.12
28097,Montgomery,ms,103,120,17,39,61,22,0.2,0.73
13009,Baldwin,ga,109,127,18,39,62,23,0.16,0.44
45011,Barnwell,sc,112,131,19,39,63,24,0.21,0.62
1085,Lowndes,al,113,132,19,39,63,24,0.09,0.29
1099,Monroe,al,120,138,18,39,65,26,0.06,0.33
47043,Dickson,tn,89,107,18,38,58,20,0.33,1.1
21143,Lyon,ky,89,107,18,38,58,20,0.41,1.78
13293,Upson,ga,108,128,20,38,62,24,0.12,0.41
1109,Pike,al,115,134,19,38,63,25,0.17,0.45
40109,Oklahoma,ok,92,108,16,37,57,20,0.12,0.53
47033,Crockett,tn,91,109,18,37,57,20,0.25,1.36
5121,Randolph,ar,90,107,17,37,58,21,0.22,1.42
1075,Lamar,al,103,120,17,37,58,21,0.12,0.53
1057,Fayette,al,102,119,17,37,58,21,0.07,0.3
1001,Autauga,al,109,128,19,37,60,23,0.09,0.28
47005,Benton,tn,90,109,19,36,56,20,0.27,1.09
29181,Ripley,mo,87,105,18,36,56,20,0.27,1.47
20099,Labette,ks,83,100,17,36,56,20,0.36,1.52
47097,Lauderdale,tn,91,109,18,36,57,21,0.35,1.89
47053,Gibson,tn,91,109,18,36,57,21,0.29,1.37
29155,Pemiscot,mo,89,107,18,36,57,21,0.43,2.12
1051,Elmore,al,107,127,20,36,59,23,0.09,0.32
45089,Williamsburg,sc,106,124,18,36,59,23,0.23,0.9
45003,Aiken,sc,107,125,18,36,59,23,0.16,0.54
13033,Burke,ga,109,127,18,36,59,23,0.18,0.54
13269,Taylor,ga,109,129,20,36,60,24,0.07,0.29
45029,Colleton,sc,110,128,18,36,60,24,0.31,0.74
13259,Stewart,ga,111,131,20,36,60,24,0.18,0.39
13239,Quitman,ga,114,133,19,36,62,26,0.16,0.39
21007,Ballard,ky,85,103,18,35,55,20,0.41,1.96
5063,Independence,ar,89,107,18,35,55,20,0.26,1.41
40017,Canadian,ok,91,107,16,35,55,20,0.11,0.29
17153,Pulaski,il,84,103,19,35,56,21,0.4,1.93
21221,Trigg,ky,87,106,19,35,56,21,0.26,1.19
45067,Marion,sc,104,122,18,35,58,23,0.24,0.79
13225,Peach,ga,109,128,19,35,58,23,0.07,0.29
1087,Macon,al,107,126,19,35,59,24,0.11,0.34
45035,Dorchester,sc,107,125,18,35,59,24,0.17,0.52
1005,Barbour,al,112,131,19,35,60,25,0.16,0.38
47081,Hickman,tn,88,107,19,34,54,20,0.19,0.81
28141,Tishomingo,ms,94,112,18,34,54,20,0.16,0.63
1033,Colbert,al,94,112,18,34,54,20,0.12,0.52
47085,Humphreys,tn,87,106,19,34,54,20,0.25,1.04
21145,McCracken,ky,84,103,19,34,54,20,0.23,1.26
1117,Shelby,al,101,120,19,34,55,21,0.06,0.25
47111,Macon,tn,86,105,19,34,55,21,0.21,0.77
13237,Putnam,ga,103,122,19,34,57,23,0.06,0.19
13079,Crawford,ga,107,127,20,34,58,24,0.08,0.3
45075,Orangeburg,sc,107,126,19,34,58,24,0.18,0.55
1031,Coffee,al,114,133,19,34,59,25,0.07,0.21
47045,Dyer,tn,87,105,18,33,53,20,0.34,1.85
1077,Lauderdale,al,93,112,19,33,53,20,0.16,0.69
47083,Houston,tn,86,105,19,33,53,20,0.19,0.91
47079,Henry,tn,86,105,19,33,53,20,0.21,1.08
1073,Jefferson,al,99,117,18,33,54,21,0.05,0.18
45041,Florence,sc,102,120,18,33,55,22,0.32,0.83
45017,Calhoun,sc,104,123,19,33,56,23,0.23,0.68
1093,Marion,al,94,113,19,32,51,19,0.12,0.53
21055,Crittenden,ky,82,101,19,32,52,20,0.3,1.32
13035,Butts,ga,100,119,19,32,53,21,0.11,0.31
45031,Darlington,sc,99,118,19,32,53,21,0.3,0.81
45043,Georgetown,sc,102,121,19,32,55,23,0.24,0.93
17059,Gallatin,il,80,98,18,31,51,20,0.22,0.95
37013,Beaufort,nc,88,107,19,31,52,21,0.28,1.08
40001,Adair,ok,82,100,18,31,52,21,0.21,1.04
1037,Coosa,al,100,119,19,31,53,22,0.11,0.31
17151,Pope,il,79,99,20,30,50,20,0.22,1.19
45069,Marlboro,sc,96,115,19,30,51,21,0.21,0.68
17077,Jackson,il,78,97,19,30,51,21,0.19,1.27
45025,Chesterfield,sc,93,112,19,29,49,20,0.28,0.82
1019,Cherokee,al,92,111,19,29,49,20,0.08,0.25
45061,Lee,sc,97,116,19,29,50,21,0.29,0.82
48263,Kent,tx,100,118,18,29,52,23,0.02,0.07
48441,Taylor,tx,103,122,19,29,53,24,0.04,0.11
12091,Okaloosa,fl,116,133,17,28,56,28,0.05,0.12
1015,Calhoun,al,91,111,20,27,47,20,0.09,0.22
13145,Harris,ga,98,118,20,27,48,21,0.04,0.2
13285,Troup,ga,96,116,20,27,48,21,0.08,0.25
45019,Charleston,sc,98,116,18,27,49,22,0.14,0.52
47165,Sumner,tn,80,100,20,26,45,19,0.08,0.42
1081,Lee,al,97,117,20,26,47,21,0.06,0.2
48335,Mitchell,tx,103,122,19,26,50,24,0.02,0.06
48103,Crane,tx,114,132,18,25,49,24,0,0.01
48235,Irion,tx,107,126,19,25,49,24,0.02,0.04
48461,Upton,tx,113,131,18,25,49,24,0.01,0.02
48435,Sutton,tx,111,130,19,25,50,25,0.01,0.04
5007,Benton,ar,74,94,20,24,44,20,0.1,0.76
5143,Washington,ar,74,93,19,24,44,20,0.11,0.57
48495,Winkler,tx,113,131,18,24,47,23,0.01,0.01
48385,Real,tx,109,129,20,23,46,23,0.04,0.08
48171,Gillespie,tx,108,127,19,23,47,24,0.02,0.03
48431,Sterling,tx,103,122,19,22,45,23,0.03,0.06
48137,Edwards,tx,109,128,19,22,46,24,0.04,0.09
48105,Crockett,tx,107,125,18,21,45,24,0.02,0.04
49053,Washington,ut,96,109,13,20,36,16,0.01,0.01
4009,Graham,az,113,130,17,20,40,20,0.01,0.04
40147,Washington,ok,97,113,16,50,70,20,0.56,2.33
40037,Creek,ok,97,113,16,47,68,21,0.46,1.54
40103,Noble,ok,96,112,16,46,65,19,0.09,0.59
40053,Grant,ok,96,110,14,45,64,19,0.14,0.33
40083,Logan,ok,97,112,15,45,64,19,0.11,0.6
40113,Osage,ok,94,111,17,45,65,20,0.55,2.21
40117,Pawnee,ok,95,112,17,45,65,20,0.22,1.08
40105,Nowata,ok,93,109,16,45,66,21,0.3,1.68
1065,Hale,al,115,132,17,45,68,23,0.12,0.41
40093,Major,ok,96,111,15,44,63,19,0.08,0.34
40071,Kay,ok,93,108,15,43,62,19,0.16,0.64
40119,Payne,ok,94,110,16,43,62,19,0.17,0.95
40003,Alfalfa,ok,95,109,14,43,62,19,0.13,0.25
40099,Murray,ok,100,116,16,43,65,22,0.15,0.78
40047,Garfield,ok,94,108,14,42,61,19,0.08,0.33
5147,Woodruff,ar,100,116,16,42,63,21,0.23,1.47
5037,Cross,ar,100,116,16,42,63,21,0.22,1.66
5123,St. Francis,ar,101,117,16,42,63,21,0.29,1.81
5077,Lee,ar,102,118,16,42,64,22,0.26,1.66
1091,Marengo,al,116,133,17,42,66,24,0.19,0.52
5075,Lawrence,ar,93,111,18,40,60,20,0.28,1.73
28137,Tate,ms,100,116,16,40,62,22,0.29,1.76
40011,Blaine,ok,94,109,15,39,58,19,0.09,0.37
20125,Montgomery,ks,87,103,16,39,59,20,0.4,1.51
40027,Cleveland,ok,95,111,16,39,60,21,0.19,0.6
5055,Greene,ar,93,111,18,39,60,21,0.31,1.74
1007,Bibb,al,106,124,18,39,60,21,0.13,0.33
29133,Mississippi,mo,88,106,18,38,59,21,0.42,1.99
1105,Perry,al,109,127,18,38,61,23,0.09,0.32
29207,Stoddard,mo,88,106,18,37,57,20,0.33,1.97
29143,New Madrid,mo,86,104,18,36,56,20,0.29,1.73
21035,Calloway,ky,88,107,19,36,56,20,0.24,1.13
13163,Jefferson,ga,109,128,19,36,59,23,0.08,0.27
20007,Barber,ks,89,103,14,35,53,18,0.16,0.23
20205,Wilson,ks,82,99,17,35,54,19,0.27,1.13
5135,Sharp,ar,86,104,18,35,55,20,0.26,1.25
5023,Cleburne,ar,88,105,17,35,55,20,0.23,1.14
20037,Crawford,ks,82,99,17,35,55,20,0.36,1.4
20021,Cherokee,ks,83,100,17,35,55,20,0.39,1.55
20011,Bourbon,ks,81,98,17,35,55,20,0.48,1.65
21233,Webster,ky,86,104,18,35,55,20,0.3,1.24
21107,Hopkins,ky,87,106,19,35,55,20,0.29,1.22
29201,Scott,mo,85,104,19,35,56,21,0.34,1.81
17003,Alexander,il,84,103,19,35,56,21,0.42,1.99
21075,Fulton,ky,87,106,19,35,56,21,0.25,1.55
21039,Carlisle,ky,86,105,19,35,56,21,0.35,1.64
47095,Lake,tn,87,105,18,35,56,21,0.24,1.46
1121,Talladega,al,102,120,18,35,57,22,0.09,0.32
40059,Harper,ok,90,104,14,34,52,18,0.02,0.13
5065,Izard,ar,85,103,18,34,53,19,0.3,1.01
20133,Neosho,ks,80,97,17,34,53,19,0.32,1.25
47183,Weakley,tn,87,106,19,34,54,20,0.24,1.24
5141,Van Buren,ar,86,103,17,34,54,20,0.21,1.19
1127,Walker,al,99,117,18,34,54,20,0.03,0.18
47017,Carroll,tn,88,107,19,34,54,20,0.23,1.22
29023,Butler,mo,86,104,18,34,55,21,0.27,1.62
47131,Obion,tn,86,105,19,34,55,21,0.23,1.44
21105,Hickman,ky,86,105,19,34,55,21,0.26,1.51
17127,Massac,il,84,103,19,34,55,21,0.19,1.17
13207,Monroe,ga,105,124,19,34,56,22,0.11,0.33
20049,Elk,ks,82,98,16,33,52,19,0.25,0.97
29217,Vernon,mo,79,96,17,33,53,20,0.52,1.67
45063,Lexington,sc,101,119,18,33,53,20,0.29,0.68
47125,Montgomery,tn,86,105,19,33,53,20,0.15,0.64
45081,Saluda,sc,99,117,18,33,53,20,0.17,0.5
1021,Chilton,al,102,121,19,33,54,21,0.06,0.18
45079,Richland,sc,101,120,19,33,54,21,0.29,0.69
1123,Tallapoosa,al,102,122,20,33,55,22,0.12,0.35
13245,Richmond,ga,103,122,19,32,53,21,0.12,0.37
21083,Graves,ky,84,104,20,32,53,21,0.18,1.18
13141,Hancock,ga,102,121,19,32,54,22,0.1,0.29
47169,Trousdale,tn,87,106,19,32,54,22,0.11,0.61
20095,Kingman,ks,84,98,14,31,49,18,0.09,0.19
20045,Douglas,ks,75,91,16,31,49,18,0.49,1.58
40043,Dewey,ok,87,102,15,31,49,18,0.08,0.28
17193,White,il,78,96,18,31,50,19,0.36,1.26
29039,Cedar,mo,77,94,17,31,51,20,0.54,1.66
47021,Cheatham,tn,85,103,18,31,51,20,0.27,0.81
20001,Allen,ks,78,95,17,31,51,20,0.44,1.36
29035,Carter,mo,80,99,19,31,51,20,0.33,1.45
29011,Barton,mo,78,95,17,31,51,20,0.33,1.39
47161,Stewart,tn,84,103,19,31,51,20,0.24,1.08
17165,Saline,il,80,99,19,31,51,20,0.13,0.94
17181,Union,il,79,99,20,31,51,20,0.17,1.24
21047,Christian,ky,84,103,19,31,51,20,0.25,0.91
21177,Muhlenberg,ky,83,102,19,31,51,20,0.27,1.04
21149,McLean,ky,82,101,19,31,51,20,0.27,0.9
37165,Scotland,nc,97,116,19,31,52,21,0.24,0.6
13133,Greene,ga,98,117,19,31,52,21,0.06,0.18
1115,St. Clair,al,96,115,19,31,52,21,0.06,0.19
45071,Newberry,sc,97,116,19,31,52,21,0.14,0.41
45065,McCormick,sc,98,117,19,31,52,21,0.12,0.31
13125,Glascock,ga,102,121,19,31,52,21,0.06,0.17
45033,Dillon,sc,98,116,18,31,52,21,0.22,0.7
45085,Sumter,sc,102,120,18,31,53,22,0.29,0.82
13231,Pike,ga,98,118,20,31,53,22,0.14,0.47
13171,Lamar,ga,100,120,20,31,54,23,0.14,0.47
5005,Baxter,ar,80,98,18,30,48,18,0.19,0.88
51149,Prince George,va,83,101,18,30,49,19,0.24,0.83
51175,Southampton,va,84,102,18,30,49,19,0.33,1.05
40009,Beckham,ok,91,107,16,30,49,19,0.06,0.26
5137,Stone,ar,81,98,17,30,49,19,0.27,1
20003,Anderson,ks,76,93,17,30,49,19,0.44,1.36
20107,Linn,ks,75,92,17,30,49,19,0.48,1.56
51595,Emporia,va,82,101,19,30,49,19,0.24,0.9
29185,St. Clair,mo,76,93,17,30,50,20,0.54,1.81
1055,Etowah,al,93,112,19,30,50,20,0.11,0.29
17047,Edwards,il,77,95,18,30,50,20,0.33,1.32
37153,Richmond,nc,94,113,19,30,50,20,0.21,0.66
47135,Perry,tn,86,105,19,30,50,20,0.17,0.89
37015,Bertie,nc,86,105,19,30,50,20,0.49,1.16
29223,Wayne,mo,78,97,19,30,50,20,0.31,1.69
21227,Warren,ky,82,102,20,30,50,20,0.14,0.51
1079,Lawrence,al,91,110,19,30,50,20,0.09,0.3
21225,Union,ky,80,99,19,30,50,20,0.24,1.13
13181,Lincoln,ga,97,117,20,30,51,21,0.07,0.19
13303,Washington,ga,101,120,19,30,51,21,0.14,0.39
37079,Greene,nc,93,111,18,30,51,21,0.11,0.49
45037,Edgefield,sc,99,117,18,30,51,21,0.18,0.46
37187,Washington,nc,88,108,20,30,51,21,0.22,0.74
13159,Jasper,ga,98,118,20,30,52,22,0.08,0.26
20033,Comanche,ks,84,99,15,29,46,17,0.13,0.2
47119,Maury,tn,85,104,19,29,48,19,0.13,0.47
1059,Franklin,al,89,108,19,29,48,19,0.09,0.53
5089,Marion,ar,80,98,18,29,48,19,0.12,0.7
29057,Dade,mo,76,94,18,29,49,20,0.31,1.32
37065,Edgecombe,nc,87,106,19,29,49,20,0.21,0.64
17157,Randolph,il,76,95,19,29,49,20,0.41,1.69
13211,Morgan,ga,95,115,20,29,49,20,0.04,0.17
17055,Franklin,il,76,95,19,29,49,20,0.21,1.17
37195,Wilson,nc,88,106,18,29,49,20,0.2,0.57
21059,Daviess,ky,79,98,19,29,49,20,0.3,0.89
17199,Williamson,il,76,95,19,29,49,20,0.11,1.01
29510,St. Louis,mo,74,94,20,29,50,21,0.32,1.62
13263,Talbot,ga,100,121,21,29,51,22,0.07,0.21
20015,Butler,ks,78,93,15,28,45,17,0.18,0.49
20169,Saline,ks,76,91,15,28,45,17,0.12,0.28
20113,McPherson,ks,78,93,15,28,46,18,0.11,0.27
20079,Harvey,ks,78,93,15,28,46,18,0.17,0.41
37007,Anson,nc,91,110,19,28,47,19,0.22,0.66
51081,Greensville,va,81,100,19,28,47,19,0.27,0.94
21141,Logan,ky,80,99,19,28,47,19,0.22,0.73
29017,Bollinger,mo,76,95,19,28,47,19,0.27,1.76
29153,Ozark,mo,77,96,19,28,47,19,0.11,0.73
47149,Rutherford,tn,85,105,20,28,48,20,0.08,0.31
17185,Wabash,il,75,93,18,28,48,20,0.35,1.29
21183,Ohio,ky,80,99,19,28,48,20,0.28,0.86
37155,Robeson,nc,94,113,19,28,48,20,0.23,0.7
45039,Fairfield,sc,93,112,19,28,48,20,0.19,0.41
17069,Hardin,il,77,97,20,28,48,20,0.14,0.78
21219,Todd,ky,81,100,19,28,48,20,0.18,0.76
21009,Barren,ky,81,101,20,28,48,20,0.14,0.53
21061,Edmonson,ky,81,100,19,28,48,20,0.14,0.49
47187,Williamson,tn,84,103,19,28,48,20,0.26,0.73
17065,Hamilton,il,75,94,19,28,48,20,0.17,0.92
1017,Chambers,al,97,117,20,28,49,21,0.04,0.2
13073,Columbia,ga,98,117,19,28,49,21,0.08,0.22
37191,Wayne,nc,90,109,19,28,49,21,0.2,0.53
13199,Meriwether,ga,97,117,20,28,49,21,0.06,0.21
20061,Geary,ks,74,89,15,27,44,17,0.19,0.48
40153,Woodward,ok,84,98,14,27,45,18,0.06,0.2
29101,Johnson,mo,71,88,17,27,45,18,0.48,1.46
18129,Posey,in,75,93,18,27,46,19,0.36,1.23
47003,Bedford,tn,84,104,20,27,46,19,0.05,0.24
47117,Marshall,tn,84,103,19,27,46,19,0.06,0.26
1103,Morgan,al,87,107,20,27,46,19,0.05,0.16
1133,Winston,al,89,108,19,27,46,19,0.02,0.17
29071,Franklin,mo,72,91,19,27,46,19,0.28,1.38
21031,Butler,ky,78,98,20,27,47,20,0.18,0.64
37093,Hoke,nc,91,110,19,27,47,20,0.25,0.61
13217,Newton,ga,92,113,21,27,47,20,0.06,0.23
47189,Wilson,tn,83,103,20,27,47,20,0.09,0.4
37107,Lenoir,nc,90,109,19,27,47,20,0.15,0.49
37047,Columbus,nc,93,112,19,27,47,20,0.22,0.71
37147,Pitt,nc,88,106,18,27,47,20,0.15,0.66
13151,Henry,ga,92,113,21,27,47,20,0.07,0.23
29119,McDonald,mo,77,96,19,27,47,20,0.17,1.05
21213,Simpson,ky,80,100,20,27,47,20,0.08,0.39
37041,Chowan,nc,82,102,20,27,47,20,0.18,0.67
37061,Duplin,nc,91,110,19,27,47,20,0.28,0.78
47159,Smith,tn,82,102,20,27,47,20,0.11,0.53
13189,McDuffie,ga,96,116,20,27,48,21,0.04,0.14
21003,Allen,ky,80,100,20,27,48,21,0.19,0.71
13301,Warren,ga,96,116,20,27,48,21,0.04,0.15
21101,Henderson,ky,78,97,19,27,48,21,0.27,0.89
17145,Perry,il,75,94,19,27,48,21,0.16,1.09
17163,St. Clair,il,73,92,19,27,48,21,0.32,1.61
6031,Kings,ca,97,113,16,26,42,16,0,0.03
6019,Fresno,ca,96,111,15,26,43,17,0.03,0.22
6107,Tulare,ca,95,110,15,26,43,17,0.02,0.08
20009,Barton,ks,78,93,15,26,43,17,0.06,0.13
20025,Clark,ks,83,97,14,26,43,17,0.02,0.14
20017,Chase,ks,73,89,16,26,43,17,0.16,0.55
37083,Halifax,nc,80,99,19,26,44,18,0.19,0.63
20173,Sedgwick,ks,78,93,15,26,44,18,0.12,0.34
20031,Coffey,ks,72,89,17,26,44,18,0.26,1.03
29179,Reynolds,mo,72,91,19,26,44,18,0.31,1.36
45047,Greenwood,sc,89,109,20,26,45,19,0.17,0.42
13219,Oconee,ga,89,110,21,26,45,19,0.06,0.19
45059,Laurens,sc,88,108,20,26,45,19,0.11,0.28
47037,Davidson,tn,82,102,20,26,45,19,0.17,0.5
45001,Abbeville,sc,89,109,20,26,45,19,0.08,0.18
29203,Shannon,mo,73,92,19,26,45,19,0.28,1.18
29105,Laclede,mo,71,90,19,26,45,19,0.32,1.27
13149,Heard,ga,94,114,20,26,46,20,0.06,0.21
29189,St. Louis,mo,71,91,20,26,46,20,0.28,1.58
37103,Jones,nc,89,108,19,26,46,20,0.11,0.57
1009,Blount,al,90,109,19,26,46,20,0.03,0.2
29099,Jefferson,mo,71,90,19,26,46,20,0.26,1.42
18147,Spencer,in,74,93,19,25,43,18,0.32,0.91
29067,Douglas,mo,71,90,19,25,43,18,0.13,0.89
29091,Howell,mo,71,90,19,25,43,18,0.14,0.81
37167,Stanly,nc,85,105,20,25,43,18,0.17,0.59
1043,Cullman,al,89,109,20,25,44,19,0.03,0.22
13059,Clarke,ga,88,109,21,25,44,19,0.06,0.14
47181,Wayne,tn,82,101,19,25,44,19,0.12,0.71
18173,Warrick,in,75,94,19,25,44,19,0.28,0.85
29065,Dent,mo,70,89,19,25,44,19,0.2,0.98
37177,Tyrrell,nc,81,101,20,25,45,20,0.14,0.49
21171,Monroe,ky,78,98,20,25,45,20,0.19,0.71
37143,Perquimans,nc,79,99,20,25,45,20,0.16,0.64
13221,Oglethorpe,ga,89,109,20,25,45,20,0.1,0.2
47121,Meigs,tn,82,104,22,25,46,21,0.06,0.45
17133,Monroe,il,71,90,19,25,46,21,0.32,1.69
37085,Harnett,nc,84,104,20,24,42,18,0.19,0.61
40129,Roger Mills,ok,85,101,16,24,42,18,0.02,0.1
5015,Carroll,ar,73,93,20,24,43,19,0.09,0.57
37139,Pasquotank,nc,77,97,20,24,43,19,0.22,0.81
47055,Giles,tn,82,102,20,24,43,19,0.13,0.29
13113,Fayette,ga,90,111,21,24,43,19,0.04,0.12
5129,Searcy,ar,74,92,18,24,43,19,0.14,0.74
17081,Jefferson,il,70,89,19,24,43,19,0.19,1.16
17025,Clay,il,70,89,19,24,43,19,0.18,0.89
13247,Rockdale,ga,88,110,22,24,43,19,0.06,0.21
37017,Bladen,nc,90,109,19,24,44,20,0.18,0.58
47143,Rhea,tn,80,102,22,24,44,20,0.06,0.45
13063,Clayton,ga,89,110,21,24,44,20,0.03,0.14
13255,Spalding,ga,90,111,21,24,44,20,0.09,0.21
48345,Motley,tx,93,111,18,24,45,21,0.02,0.09
48353,Nolan,tx,101,120,19,24,47,23,0.02,0.05
29117,Livingston,mo,66,83,17,23,40,17,0.54,1.34
45057,Lancaster,sc,84,104,20,23,41,18,0.23,0.53
29137,Monroe,mo,67,85,18,23,41,18,0.3,1.32
37025,Cabarrus,nc,82,102,20,23,41,18,0.07,0.29
29151,Osage,mo,67,86,19,23,41,18,0.19,0.99
37125,Moore,nc,84,104,20,23,42,19,0.17,0.52
5009,Boone,ar,73,92,19,23,42,19,0.08,0.58
1111,Randolph,al,90,110,20,23,42,19,0.04,0.19
21087,Green,ky,75,95,20,23,42,19,0.07,0.33
13077,Coweta,ga,90,112,22,23,43,20,0.03,0.18
45051,Horry,sc,91,109,18,23,43,20,0.24,0.79
17189,Washington,il,69,89,20,23,43,20,0.17,1.13
17159,Richland,il,70,89,19,23,43,20,0.28,0.99
47027,Clay,tn,77,99,22,23,43,20,0.07,0.38
21057,Cumberland,ky,77,98,21,23,43,20,0.08,0.32
48125,Dickens,tx,94,112,18,23,44,21,0.01,0.04
48415,Scurry,tx,99,118,19,23,46,23,0.01,0.04
6021,Glenn,ca,86,101,15,22,37,15,0.02,0.04
6039,Madera,ca,87,103,16,22,38,16,0.02,0.11
13115,Floyd,ga,82,104,22,22,39,17,0.06,0.26
20145,Pawnee,ks,77,91,14,22,39,17,0.11,0.22
29121,Macon,mo,65,82,17,22,39,17,0.43,1.18
47103,Lincoln,tn,80,100,20,22,40,18,0.06,0.17
13119,Franklin,ga,82,103,21,22,40,18,0.06,0.12
13129,Gordon,ga,82,103,21,22,40,18,0.04,0.22
29123,Madison,mo,67,87,20,22,40,18,0.15,1.12
13297,Walton,ga,84,106,22,22,40,18,0.04,0.15
18083,Knox,in,69,87,18,22,41,19,0.28,1.04
1095,Marshall,al,82,103,21,22,41,19,0.04,0.14
29225,Webster,mo,67,86,19,22,41,19,0.13,0.89
29007,Audrain,mo,66,84,18,22,41,19,0.23,1.16
29073,Gasconade,mo,66,86,20,22,41,19,0.2,0.94
29209,Stone,mo,71,90,19,22,41,19,0.09,0.61
47015,Cannon,tn,78,99,21,22,41,19,0.08,0.26
17027,Clinton,il,67,87,20,22,42,20,0.18,1.22
37129,New Hanover,nc,88,106,18,22,42,20,0.09,0.35
37141,Pender,nc,89,107,18,22,43,21,0.15,0.56
6101,Sutter,ca,85,102,17,21,36,15,0.02,0.02
6103,Tehama,ca,82,96,14,21,36,15,0.02,0.06
13157,Jackson,ga,81,102,21,21,38,17,0.06,0.15
13147,Hart,ga,80,102,22,21,38,17,0.07,0.12
13233,Polk,ga,83,105,22,21,39,18,0.07,0.29
29125,Maries,mo,65,85,20,21,39,18,0.24,1.16
13015,Bartow,ga,82,104,22,21,39,18,0.07,0.29
29093,Iron,mo,67,87,20,21,39,18,0.17,0.99
13013,Barrow,ga,82,103,21,21,39,18,0.05,0.15
13105,Elbert,ga,83,104,21,21,39,18,0.09,0.17
29109,Lawrence,mo,67,86,19,21,40,19,0.23,1.04
29077,Greene,mo,68,86,18,21,40,19,0.19,0.97
47107,McMinn,tn,78,100,22,21,41,20,0.05,0.31
37019,Brunswick,nc,87,105,18,21,41,20,0.14,0.61
6089,Shasta,ca,79,92,13,20,34,14,0,0.01
1029,Cleburne,al,82,104,22,20,38,18,0.02,0.14
29043,Christian,mo,66,85,19,20,38,18,0.13,0.72
29009,Barry,mo,69,88,19,20,39,19,0.16,0.77
37095,Hyde,nc,80,100,20,20,41,21,0.09,0.42
5087,Madison,ar,69,88,19,19,38,19,0.08,0.48
48265,Kerr,tx,105,124,19,19,42,23,0.04,0.08
20175,Seward,ks,79,93,14,18,34,16,0.02,0.06
40007,Beaver,ok,79,93,14,18,35,17,0.02,0.11
48129,Donley,tx,83,100,17,18,36,18,0.04,0.16
48371,Pecos,tx,106,125,19,17,36,19,0.01,0.02
48169,Garza,tx,91,110,19,17,36,19,0.02,0.04
48329,Midland,tx,104,122,18,17,38,21,0,0.02
6007,Butte,ca,74,91,17,16,30,14,0.02,0.05
13121,Fulton,ga,75,98,23,16,32,16,0.02,0.11
32023,Nye,nv,95,107,12,16,32,16,0.01,0.03
37031,Carteret,nc,82,101,19,16,36,20,0.02,0.17
48413,Schleicher,tx,101,121,20,16,38,22,0.03,0.04
48227,Howard,tx,99,117,18,16,38,22,0.01,0.05
48135,Ector,tx,100,119,19,15,35,20,0,0
6027,Inyo,ca,79,93,14,11,21,10,0.12,0.7
21065,Estill,,,,,43,67,23.11,0.04,0.16
40151,Woods,ok,95,109,14,41,60,19,0.12,0.27
20019,Chautauqua,ks,87,103,16,38,58,20,0.39,1.43
20191,Sumner,ks,87,101,14,36,54,18,0.12,0.37
20035,Cowley,ks,86,101,15,36,54,18,0.17,0.77
20077,Harper,ks,89,103,14,36,55,19,0.14,0.32
21033,Caldwell,ky,87,106,19,36,56,20,0.3,1.24
29031,Cape Girardeau,mo,83,102,19,34,54,20,0.22,1.51
51670,Hopewell,va,88,106,18,34,54,20,0.17,0.64
20143,Ottawa,ks,80,94,14,32,49,17,0.18,0.36
29013,Bates,mo,77,94,17,32,51,19,0.52,1.66
51570,Colonial Heights,va,85,103,18,32,52,20,0.17,0.61
5049,Fulton,ar,81,99,18,31,49,18,0.22,1.02
29149,Oregon,mo,80,99,19,31,50,19,0.19,1.33
29097,Jasper,mo,79,97,18,31,51,20,0.25,1.23
20041,Dickinson,ks,78,92,14,30,47,17,0.19,0.48
20059,Franklin,ks,75,92,17,30,48,18,0.35,1.14
17087,Johnson,il,79,98,19,30,51,21,0.14,1.17
20105,Lincoln,ks,78,91,13,29,46,17,0.21,0.41
20027,Clay,ks,76,91,15,29,46,17,0.14,0.42
20073,Greenwood,ks,77,93,16,29,47,18,0.27,0.88
29083,Henry,mo,74,91,17,29,48,19,0.43,1.64
20207,Woodson,ks,76,93,17,29,48,19,0.26,1.11
51730,Petersburg,va,81,100,19,29,48,19,0.18,0.64
13317,Wilkes,ga,95,114,19,29,50,21,0.1,0.22
20149,Pottawatomie,ks,74,89,15,28,44,16,0.32,0.87
20161,Riley,ks,75,90,15,28,45,17,0.23,0.62
37127,Nash,nc,84,103,19,28,46,18,0.23,0.64
20121,Miami,ks,73,90,17,28,46,18,0.34,1.33
51183,Sussex,va,79,98,19,28,46,18,0.3,1.03
20103,Leavenworth,ks,73,89,16,28,46,18,0.49,1.58
37117,Martin,nc,85,104,19,28,47,19,0.29,0.81
29085,Hickory,mo,73,91,18,28,47,19,0.43,1.56
51620,Franklin,va,81,100,19,28,47,19,0.23,0.87
29015,Benton,mo,73,91,18,28,47,19,0.43,1.63
13265,Taliaferro,ga,96,115,19,28,49,21,0.06,0.16
20085,Jackson,ks,71,87,16,27,43,16,0.29,0.83
51101,King William,va,76,95,19,27,44,17,0.27,0.85
20087,Jefferson,ks,71,88,17,27,44,17,0.49,1.58
20177,Shawnee,ks,72,88,16,27,44,17,0.35,0.94
20139,Osage,ks,72,88,16,27,44,17,0.29,0.86
20005,Atchison,ks,71,87,16,27,44,17,0.42,1.06
51053,Dinwiddie,va,79,97,18,27,45,18,0.21,0.78
51127,New Kent,va,77,96,19,27,45,18,0.26,0.79
29141,Morgan,mo,72,90,18,27,45,18,0.44,1.54
29037,Cass,mo,72,89,17,27,45,18,0.39,1.48
29029,Camden,mo,73,91,18,27,46,19,0.46,1.6
51036,Charles City,va,78,97,19,27,46,19,0.18,0.67
45087,Union,sc,89,109,20,27,46,19,0.13,0.28
37073,Gates,nc,80,99,19,27,46,19,0.26,0.89
29157,Perry,mo,74,93,19,27,47,20,0.24,1.32
29145,Newton,mo,76,95,19,27,47,20,0.21,0.97
20123,Mitchell,ks,73,87,14,26,41,15,0.09,0.28
20013,Brown,ks,70,86,16,26,42,16,0.37,0.94
20185,Stafford,ks,80,94,14,26,43,17,0.09,0.19
20155,Reno,ks,78,92,14,26,43,17,0.16,0.31
20115,Marion,ks,74,89,15,26,43,17,0.18,0.48
29131,Miller,mo,71,89,18,26,44,18,0.28,1.22
45055,Kershaw,sc,91,110,19,26,45,19,0.21,0.63
37131,Northampton,nc,80,100,20,26,45,19,0.23,0.78
37051,Cumberland,nc,89,108,19,26,45,19,0.27,0.64
47147,Robertson,tn,78,98,20,26,45,19,0.12,0.51
1083,Limestone,al,85,105,20,26,45,19,0.11,0.26
29139,Montgomery,mo,70,89,19,26,45,19,0.25,1.23
29186,Ste. Genevieve,mo,72,91,19,26,45,19,0.37,1.57
29213,Taney,mo,75,94,19,26,45,19,0.11,0.72
37049,Craven,nc,88,107,19,26,46,20,0.13,0.61
29113,Lincoln,mo,71,89,18,26,46,20,0.33,1.62
29183,St. Charles,mo,71,90,19,26,46,20,0.31,1.68
29167,Polk,mo,73,91,18,26,46,20,0.33,1.27
18163,Vanderburgh,in,76,95,19,26,46,20,0.25,0.87
31147,Richardson,ne,68,84,16,25,41,16,0.45,0.96
20053,Ellsworth,ks,75,89,14,25,42,17,0.1,0.24
51181,Surry,va,74,93,19,25,42,17,0.22,0.77
20159,Rice,ks,77,91,14,25,42,17,0.11,0.23
20197,Wabaunsee,ks,71,87,16,25,42,17,0.35,0.93
29195,Saline,mo,70,87,17,25,43,18,0.56,1.57
29033,Carroll,mo,70,87,17,25,43,18,0.44,1.44
51095,James City,va,74,94,20,25,43,18,0.16,0.56
20091,Johnson,ks,70,87,17,25,43,18,0.46,1.46
20209,Wyandotte,ks,71,87,16,25,43,18,0.42,1.26
45023,Chester,sc,87,107,20,25,43,18,0.21,0.39
21091,Hancock,ky,74,93,19,25,43,18,0.28,0.85
13313,Whitfield,ga,85,106,21,25,44,19,0.04,0.23
37123,Montgomery,nc,85,105,20,25,44,19,0.19,0.59
37163,Sampson,nc,88,107,19,25,44,19,0.19,0.63
18051,Gibson,in,72,91,19,25,44,19,0.35,1.24
47101,Lewis,tn,81,101,20,25,44,19,0.07,0.46
29135,Moniteau,mo,70,88,18,25,44,19,0.24,1.06
29051,Cole,mo,70,89,19,25,44,19,0.21,0.99
17033,Crawford,il,70,88,18,25,44,19,0.39,1.31
29219,Warren,mo,68,87,19,25,44,19,0.28,1.39
17101,Lawrence,il,71,89,18,25,44,19,0.3,1.02
29169,Pulaski,mo,71,90,19,25,44,19,0.23,1.17
17191,Wayne,il,72,91,19,25,45,20,0.25,1.15
37133,Onslow,nc,89,109,20,25,46,21,0.13,0.57
17119,Madison,il,69,89,20,25,46,21,0.33,1.77
20141,Osborne,ks,72,86,14,24,39,15,0.04,0.12
20043,Doniphan,ks,67,84,17,24,41,17,0.47,1.07
20151,Pratt,ks,79,93,14,24,41,17,0.06,0.12
29095,Jackson,mo,69,86,17,24,42,18,0.5,1.27
29107,Lafayette,mo,69,85,16,24,42,18,0.54,1.47
37091,Hertford,nc,77,97,20,24,42,18,0.22,0.78
20111,Lyon,ks,71,87,16,24,42,18,0.24,0.73
29165,Platte,mo,69,86,17,24,42,18,0.43,1.15
29053,Cooper,mo,69,86,17,24,42,18,0.49,1.43
51800,Suffolk,va,72,92,20,24,42,18,0.36,1.13
29161,Phelps,mo,68,87,19,24,42,18,0.25,1.16
1089,Madison,al,83,103,20,24,43,19,0.04,0.11
29019,Boone,mo,68,86,18,24,43,19,0.32,1.31
1071,Jackson,al,81,102,21,24,43,19,0.06,0.18
51830,Williamsburg,va,73,93,20,24,43,19,0.11,0.43
13055,Chattooga,ga,84,104,20,24,43,19,0.04,0.2
29059,Dallas,mo,70,89,19,24,43,19,0.34,1.34
21099,Hart,ky,77,97,20,24,44,20,0.11,0.42
17013,Calhoun,il,68,88,20,24,44,20,0.31,1.68
37137,Pamlico,nc,87,106,19,24,45,21,0.11,0.58
51057,Essex,va,70,89,19,23,39,16,0.13,0.49
20131,Nemaha,ks,67,83,16,23,39,16,0.24,0.66
20201,Washington,ks,70,84,14,23,39,16,0.19,0.41
51041,Chesterfield,va,73,92,19,23,40,17,0.17,0.67
51093,Isle of Wight,va,72,91,19,23,40,17,0.22,0.89
51025,Brunswick,va,75,95,20,23,40,17,0.22,0.71
37185,Warren,nc,77,96,19,23,40,17,0.13,0.45
29089,Howard,mo,67,85,18,23,40,17,0.47,1.4
29159,Pettis,mo,68,86,18,23,41,18,0.43,1.44
37105,Lee,nc,82,102,20,23,41,18,0.09,0.47
21027,Breckinridge,ky,72,93,21,23,41,18,0.17,0.54
29027,Callaway,mo,67,85,18,23,41,18,0.21,1.02
37101,Johnston,nc,83,102,19,23,41,18,0.12,0.48
29055,Crawford,mo,68,87,19,23,41,18,0.24,1.09
29215,Texas,mo,67,87,20,23,41,18,0.18,0.91
13195,Madison,ga,85,105,20,23,42,19,0.1,0.17
13213,Murray,ga,82,103,21,23,42,19,0.04,0.23
17121,Marion,il,69,88,19,23,43,20,0.16,0.99
20183,Smith,ks,69,84,15,22,36,14,0.03,0.13
29087,Holt,mo,64,80,16,22,37,15,0.51,1.08
31127,Nemaha,ne,64,80,16,22,37,15,0.4,0.75
20117,Marshall,ks,66,81,15,22,37,15,0.17,0.48
51159,Richmond,va,69,88,19,22,38,16,0.13,0.42
31133,Pawnee,ne,66,81,15,22,38,16,0.28,0.72
20127,Morris,ks,68,84,16,22,38,16,0.13,0.46
51047,Culpeper,va,69,88,19,22,38,16,0.15,0.47
20165,Rush,ks,75,90,15,22,38,16,0.03,0.09
45091,York,sc,81,102,21,22,39,17,0.19,0.38
29041,Chariton,mo,66,83,17,22,39,17,0.44,1.35
51550,Chesapeake,va,69,88,19,22,39,17,0.33,1.01
29205,Shelby,mo,64,82,18,22,39,17,0.39,1.33
29175,Randolph,mo,65,84,19,22,39,17,0.33,1.14
37135,Orange,nc,77,96,19,22,39,17,0.14,0.53
37069,Franklin,nc,79,98,19,22,40,18,0.15,0.49
21029,Bullitt,ky,73,94,21,22,40,18,0.12,0.41
45007,Anderson,sc,82,103,21,22,40,18,0.06,0.12
37033,Caswell,nc,77,96,19,22,40,18,0.09,0.57
29229,Wright,mo,67,86,19,22,40,18,0.12,0.89
37029,Camden,nc,75,94,19,22,41,19,0.26,0.89
18123,Perry,in,71,90,19,22,41,19,0.23,0.74
17083,Jersey,il,66,86,20,22,42,20,0.31,1.68
20157,Republic,ks,66,81,15,21,35,14,0.09,0.2
29115,Linn,mo,64,81,17,21,37,16,0.55,1.25
29003,Andrew,mo,63,80,17,21,37,16,0.51,1.08
51630,Fredericksburg,va,67,87,20,21,37,16,0.05,0.21
20167,Russell,ks,72,86,14,21,37,16,0.06,0.19
51760,Richmond,va,70,89,19,21,37,16,0.08,0.28
20047,Edwards,ks,76,91,15,21,37,16,0.08,0.18
51109,Louisa,va,69,88,19,21,37,16,0.21,0.61
45083,Spartanburg,sc,80,101,21,21,38,17,0.1,0.23
37179,Union,nc,80,101,21,21,38,17,0.2,0.58
29111,Lewis,mo,62,80,18,21,38,17,0.49,1.53
51117,Mecklenburg,va,74,94,20,21,38,17,0.13,0.52
18027,Daviess,in,67,87,20,21,39,18,0.28,0.72
47065,Hamilton,tn,77,99,22,21,39,18,0.03,0.21
47127,Moore,tn,77,98,21,21,39,18,0.03,0.12
18125,Pike,in,69,88,19,21,39,18,0.26,0.81
17149,Pike,il,61,81,20,21,39,18,0.38,1.76
29221,Washington,mo,66,85,19,21,39,18,0.26,1.09
17005,Bond,il,64,85,21,21,40,19,0.19,1.19
29173,Ralls,mo,63,83,20,21,40,19,0.31,1.36
17079,Jasper,il,66,85,19,21,40,19,0.28,0.92
29163,Pike,mo,64,83,19,21,40,19,0.29,1.58
20147,Phillips,ks,68,83,15,20,34,14,0.02,0.12
20097,Kiowa,ks,74,89,15,20,35,15,0.04,0.08
6029,Kern,ca,91,105,14,20,35,15,0,0.01
20119,Meade,ks,79,93,14,20,36,16,0.01,0.08
51119,Middlesex,va,66,86,20,20,36,16,0.18,0.56
51073,Gloucester,va,67,87,20,20,37,17,0.2,0.63
1049,DeKalb,al,74,96,22,20,37,17,0.06,0.16
13257,Stephens,ga,79,101,22,20,37,17,0.04,0.11
40045,Ellis,ok,79,95,16,20,37,17,0.02,0.1
47115,Marion,tn,73,94,21,20,37,17,0.04,0.17
47041,DeKalb,tn,74,96,22,20,38,18,0.1,0.35
1027,Clay,al,84,106,22,20,38,18,0.08,0.24
13047,Catoosa,ga,77,99,22,20,38,18,0.03,0.14
18043,Floyd,in,69,90,21,20,38,18,0.12,0.35
17049,Effingham,il,64,82,18,20,38,18,0.19,0.92
47099,Lawrence,tn,77,98,21,20,38,18,0.08,0.32
47011,Bradley,tn,76,98,22,20,38,18,0.04,0.2
21179,Nelson,ky,71,92,21,20,39,19,0.11,0.37
47087,Jackson,tn,74,96,22,20,39,19,0.07,0.34
29187,St. Francois,mo,65,85,20,20,39,19,0.14,1.02
17171,Scott,il,61,82,21,20,39,19,0.36,1.73
17135,Montgomery,il,65,85,20,20,40,20,0.21,1.4
17061,Greene,il,63,84,21,20,40,20,0.27,1.62
17117,Macoupin,il,64,85,21,20,40,20,0.33,1.77
6047,Merced,ca,86,104,18,19,34,15,0.02,0.03
51199,York,va,65,85,20,19,35,16,0.13,0.47
45077,Pickens,sc,76,97,21,19,36,17,0.04,0.1
37161,Rutherford,nc,75,95,20,19,36,17,0.07,0.21
18037,Dubois,in,65,85,20,19,36,17,0.26,0.76
13089,DeKalb,ga,79,102,23,19,36,17,0.03,0.14
48483,Wheeler,tx,82,99,17,19,36,17,0.03,0.14
45073,Oconee,sc,77,99,22,19,37,18,0.05,0.1
47145,Roane,tn,73,96,23,19,37,18,0.04,0.24
13295,Walker,ga,75,97,22,19,37,18,0.03,0.13
17173,Shelby,il,62,82,20,19,37,18,0.21,1.17
47177,Warren,tn,74,96,22,19,37,18,0.03,0.17
17041,Douglas,il,61,81,20,19,37,18,0.38,1.18
17051,Fayette,il,62,82,20,19,37,18,0.21,1.02
17035,Cumberland,il,63,82,19,19,37,18,0.26,0.84
18153,Sullivan,in,63,82,19,19,37,18,0.37,1.18
51590,Danville,va,73,93,20,19,37,18,0.03,0.28
21001,Adair,ky,70,91,21,19,38,19,0.08,0.31
17023,Clark,il,64,83,19,19,38,19,0.35,1.05
6011,Colusa,ca,81,98,17,18,32,14,0.01,0.03
20051,Ellis,ks,70,84,14,18,32,14,0.04,0.13
29075,Gentry,mo,59,75,16,18,32,14,0.34,0.76
31067,Gage,ne,61,77,16,18,32,14,0.18,0.36
29147,Nodaway,mo,58,75,17,18,32,14,0.46,0.89
19101,Jefferson,ia,55,74,19,18,33,15,0.55,1.41
29199,Scotland,mo,57,75,18,18,33,15,0.41,1.28
51037,Charlotte,va,67,87,20,18,33,15,0.1,0.38
24045,Wicomico,md,60,79,19,18,33,15,0.14,0.62
51087,Henrico,va,65,85,20,18,33,15,0.17,0.67
48043,Brewster,tx,99,120,21,18,33,15,0.08,0.34
51029,Buckingham,va,66,86,20,18,33,15,0.08,0.39
20083,Hodgeman,ks,74,89,15,18,33,15,0.03,0.08
51135,Nottoway,va,66,86,20,18,33,15,0.22,0.6
51710,Norfolk,va,61,81,20,18,33,15,0.19,0.66
20135,Ness,ks,74,88,14,18,34,16,0.01,0.04
19111,Lee,ia,56,76,20,18,34,16,0.46,1.46
51083,Halifax,va,69,89,20,18,34,16,0.12,0.38
51111,Lunenburg,va,68,88,20,18,34,16,0.16,0.56
51103,Lancaster,va,66,85,19,18,34,16,0.09,0.32
13011,Banks,ga,75,97,22,18,34,16,0.04,0.13
37149,Polk,nc,73,94,21,18,35,17,0.07,0.2
47031,Coffee,tn,73,95,22,18,35,17,0.03,0.16
13223,Paulding,ga,78,101,23,18,35,17,0.04,0.24
21041,Carroll,ky,64,85,21,18,35,17,0.14,0.55
21215,Spencer,ky,67,88,21,18,35,17,0.11,0.3
17045,Edgar,il,60,79,19,18,35,17,0.38,1.09
13097,Douglas,ga,80,103,23,18,35,17,0.02,0.08
21093,Hardin,ky,67,88,21,18,36,18,0.12,0.35
21217,Taylor,ky,68,90,22,18,36,18,0.07,0.28
21111,Jefferson,ky,67,88,21,18,36,18,0.11,0.32
17139,Moultrie,il,60,80,20,18,36,18,0.19,1.01
17125,Mason,il,58,79,21,18,37,19,0.49,2.06
17021,Christian,il,61,81,20,18,37,19,0.26,1.32
47105,Loudon,tn,75,97,22,18,38,20,0.03,0.16
48033,Borden,tx,97,117,20,18,39,21,0.01,0.03
31185,York,ne,58,74,16,17,30,13,0.18,0.41
29227,Worth,mo,57,74,17,17,31,14,0.31,0.64
24019,Dorchester,md,61,80,19,17,31,14,0.11,0.52
19087,Henry,ia,54,72,18,17,32,15,0.52,1.49
19145,Page,ia,57,74,17,17,32,15,0.59,1.11
37097,Iredell,nc,71,92,21,17,32,15,0.05,0.19
51650,Hampton,va,61,81,20,17,32,15,0.18,0.56
37059,Davie,nc,72,93,21,17,33,16,0.02,0.12
37057,Davidson,nc,73,93,20,17,33,16,0.05,0.24
18105,Monroe,in,59,78,19,17,33,16,0.33,0.77
18155,Switzerland,in,61,82,21,17,33,16,0.2,0.67
37109,Lincoln,nc,72,93,21,17,33,16,0.08,0.26
48211,Hemphill,tx,79,95,16,17,33,16,0.02,0.07
21155,Marion,ky,66,88,22,17,34,17,0.08,0.29
5101,Newton,ar,64,83,19,17,34,17,0.12,0.62
17029,Coles,il,59,79,20,17,34,17,0.3,1.06
18165,Vermillion,in,59,79,20,17,34,17,0.43,1.07
47185,White,tn,71,93,22,17,35,18,0.03,0.19
18167,Vigo,in,60,80,20,17,35,18,0.31,0.78
47137,Pickett,tn,69,91,22,17,35,18,0.05,0.26
17129,Menard,il,57,78,21,17,36,19,0.43,2.04
17167,Sangamon,il,58,79,21,17,36,19,0.36,1.87
48383,Reagan,tx,101,119,18,17,40,23,0.01,0.02
6115,Yuba,ca,75,93,18,16,29,13,0.02,0.04
6113,Yolo,ca,76,95,19,16,29,13,0.02,0.01
48295,Lipscomb,tx,76,91,15,16,31,15,0.02,0.06
13135,Gwinnett,ga,73,96,23,16,32,16,0.04,0.14
21187,Owen,ky,62,84,22,16,32,16,0.11,0.38
18121,Parke,in,58,77,19,16,32,16,0.43,1.07
47001,Anderson,tn,70,93,23,16,33,17,0.03,0.16
21229,Washington,ky,65,87,22,16,33,17,0.08,0.28
47123,Monroe,tn,70,93,23,16,33,17,0.03,0.14
47093,Knox,tn,71,94,23,16,33,17,0.03,0.13
18079,Jennings,in,60,80,20,16,33,17,0.21,0.61
13045,Carroll,ga,77,101,24,16,33,17,0.02,0.13
21211,Shelby,ky,64,85,21,16,33,17,0.09,0.28
21223,Trimble,ky,62,83,21,16,33,17,0.11,0.45
21207,Russell,ky,66,88,22,16,34,18,0.08,0.29
17147,Piatt,il,57,77,20,16,34,18,0.28,1.23
47141,Putnam,tn,68,90,22,16,34,18,0.05,0.26
48317,Martin,tx,100,119,19,16,37,21,0,0.02
45045,Greenville,sc,68,90,22,15,29,14,0.05,0.13
51133,Northumberland,va,64,83,19,15,31,16,0.06,0.23
18021,Clay,in,57,76,19,15,31,16,0.33,0.66
17183,Vermilion,il,55,74,19,15,31,16,0.41,1.12
13067,Cobb,ga,74,97,23,15,31,16,0.03,0.17
51115,Mathews,va,61,81,20,15,31,16,0.05,0.19
35015,Eddy,nm,96,114,18,15,32,17,0.01,0.02
37053,Currituck,nc,66,85,19,14,30,16,0.25,0.84
47139,Polk,tn,66,89,23,14,30,16,0.04,0.16
47153,Sequatchie,tn,62,84,22,14,30,16,0.03,0.17
47009,Blount,tn,68,91,23,14,31,17,0.03,0.12
47133,Overton,tn,65,87,22,14,32,18,0.04,0.2
48173,Glasscock,tx,98,117,19,14,35,21,0.01,0.03
19001,Adair,ia,49,65,16,13,24,11,0.24,0.46
6099,Stanislaus,ca,73,92,19,13,24,11,0.01,0.02
19029,Cass,ia,49,65,16,13,24,11,0.37,0.69
6067,Sacramento,ca,68,88,20,13,24,11,0.02,0.01
37023,Burke,nc,62,84,22,13,26,13,0.04,0.1
21017,Bourbon,ky,57,79,22,13,27,14,0.04,0.22
18133,Putnam,in,51,71,20,13,27,14,0.36,0.75
51678,Lexington,va,59,80,21,13,27,14,0.06,0.21
21097,Harrison,ky,58,80,22,13,28,15,0.05,0.24
21011,Bath,ky,59,81,22,13,28,15,0.04,0.19
21021,Boyle,ky,59,81,22,13,28,15,0.04,0.16
21115,Johnson,ky,60,82,22,13,28,15,0.06,0.22
21231,Wayne,ky,62,84,22,13,29,16,0.06,0.21
47057,Grainger,tn,64,88,24,13,29,16,0.01,0.09
21079,Garrard,ky,60,83,23,13,29,16,0.06,0.19
21045,Casey,ky,61,83,22,13,29,16,0.07,0.21
21199,Pulaski,ky,62,85,23,13,29,16,0.04,0.19
47007,Bledsoe,tn,60,83,23,13,29,16,0.03,0.23
47089,Jefferson,tn,66,90,24,13,30,17,0.01,0.09
48003,Andrews,tx,100,120,20,13,33,20,0.01,0.01
6061,Placer,ca,61,77,16,12,23,11,0.02,0.03
6071,San Bernardino,ca,75,90,15,12,24,12,0.69,2.56
4011,Greenlee,az,94,113,19,12,25,13,0,0.01
13117,Forsyth,ga,64,88,24,12,25,13,0.02,0.11
20039,Decatur,ks,61,76,15,12,25,13,0,0.01
24037,St. Mary's,md,55,74,19,12,25,13,0.11,0.58
13139,Hall,ga,64,88,24,12,26,14,0.04,0.14
21089,Greenup,ky,57,79,22,12,26,14,0.08,0.17
21201,Robertson,ky,56,77,21,12,26,14,0.03,0.22
37003,Alexander,nc,62,84,22,12,26,14,0.03,0.1
18145,Shelby,in,51,71,20,12,26,14,0.27,0.58
21117,Kenton,ky,54,75,21,12,26,14,0.13,0.43
37067,Forsyth,nc,64,86,22,12,26,14,0.05,0.13
39087,Lawrence,oh,57,78,21,12,26,14,0.06,0.18
21151,Madison,ky,58,81,23,12,27,15,0.04,0.17
21049,Clark,ky,57,79,22,12,27,15,0.05,0.17
21181,Nicholas,ky,56,78,22,12,27,15,0.04,0.22
21197,Powell,ky,58,80,22,12,27,15,0.04,0.17
21209,Scott,ky,57,78,21,12,27,15,0.04,0.21
21113,Jessamine,ky,58,80,22,12,27,15,0.06,0.19
21137,Lincoln,ky,58,81,23,12,27,15,0.04,0.16
21191,Pendleton,ky,55,77,22,12,27,15,0.09,0.28
48195,Hansford,tx,77,93,16,12,27,15,0.03,0.02
47175,Van Buren,tn,59,81,22,12,27,15,0.03,0.16
47173,Union,tn,63,86,23,12,28,16,0.01,0.12
21205,Rowan,ky,55,77,22,11,25,14,0.03,0.19
40139,Texas,ok,74,90,16,11,25,14,0.02,0.05
51131,Northampton,va,59,79,20,11,26,15,0.04,0.16
47013,Campbell,tn,59,83,24,11,26,15,0.01,0.12
37055,Dare,nc,66,85,19,11,27,16,0.01,0.11
47063,Hamblen,tn,62,86,24,11,27,16,0.01,0.08
48115,Dawson,tx,90,108,18,11,28,17,0.02,0.02
20055,Finney,ks,65,80,15,10,23,13,0.01,0.04
20189,Stevens,ks,70,85,15,10,23,13,0.02,0.04
48357,Ochiltree,tx,70,86,16,10,23,13,0.03,0.04
47025,Claiborne,tn,57,79,22,10,24,14,0.01,0.12
6005,Amador,ca,60,79,19,9,19,10,0.01,0.01
37171,Surry,nc,54,76,22,8,19,11,0.01,0.05
47029,Cocke,tn,53,76,23,8,21,13,0.01,0.08
47049,Fentress,tn,50,74,24,8,21,13,0.03,0.19
18041,Fayette,in,44,64,20,8,21,13,0.21,0.57
35029,Luna,nm,88,112,24,7,23,16,0.09,0.52
16027,Canyon,id,46,60,14,4,11,7,0,0
51097,King and Queen,va,74,94,20,26,44,18,0.27,0.85
20029,Cloud,ks,69,84,15,23,38,15,0.06,0.21
29021,Buchanan,mo,66,83,17,23,39,16,0.47,1.07
29177,Ray,mo,67,83,16,23,40,17,0.54,1.35
51099,King George,va,68,87,19,22,37,15,0.15,0.56
51193,Westmoreland,va,69,88,19,22,37,15,0.17,0.68
29047,Clay,mo,67,83,16,22,39,17,0.32,1.05
37063,Durham,nc,78,98,20,22,39,17,0.13,0.53
51740,Portsmouth,va,65,85,20,21,37,16,0.19,0.71
51075,Goochland,va,68,87,19,20,35,15,0.1,0.36
51007,Amelia,va,70,89,19,20,36,16,0.11,0.46
51049,Cumberland,va,69,89,20,20,36,16,0.08,0.41
37181,Vance,nc,74,93,19,20,36,16,0.07,0.32
51700,Newport News,va,65,85,20,20,36,16,0.15,0.59
29103,Knox,mo,61,79,18,20,36,16,0.48,1.47
17169,Schuyler,il,59,80,21,20,37,17,0.52,2.03
37037,Chatham,nc,76,97,21,20,37,17,0.11,0.47
37183,Wake,nc,77,97,20,20,37,17,0.1,0.44
37001,Alamance,nc,75,95,20,20,37,17,0.03,0.3
29127,Marion,mo,61,80,19,20,37,17,0.34,1.39
37077,Granville,nc,75,95,20,20,37,17,0.07,0.37
17017,Cass,il,60,81,21,20,38,18,0.45,2.04
20089,Jewell,ks,64,79,15,19,33,14,0.08,0.2
31095,Jefferson,ne,62,77,15,19,33,14,0.19,0.38
29061,Daviess,mo,59,76,17,19,33,14,0.49,1.02
20163,Rooks,ks,69,84,15,19,33,14,0.02,0.08
19071,Fremont,ia,60,76,16,19,34,15,0.59,1.11
51137,Orange,va,64,84,20,19,34,15,0.19,0.55
51177,Spotsylvania,va,65,84,19,19,34,15,0.18,0.52
51033,Caroline,va,66,85,19,19,34,15,0.1,0.32
51179,Stafford,va,64,83,19,19,34,15,0.06,0.26
51147,Prince Edward,va,68,88,20,19,34,15,0.07,0.4
29079,Grundy,mo,60,77,17,19,34,15,0.48,1.1
29025,Caldwell,mo,61,77,16,19,34,15,0.37,1.01
31097,Johnson,ne,61,77,16,19,34,15,0.24,0.56
51065,Fluvanna,va,66,86,20,19,34,15,0.1,0.41
29049,Clinton,mo,61,77,16,19,34,15,0.26,0.82
19177,Van Buren,ia,59,77,18,19,35,16,0.58,1.55
51145,Powhatan,va,68,87,19,19,35,16,0.08,0.37
29005,Atchison,mo,61,78,17,19,35,16,0.4,0.78
37119,Mecklenburg,nc,76,97,21,19,35,16,0.17,0.32
37071,Gaston,nc,76,97,21,19,35,16,0.09,0.26
17067,Hancock,il,58,78,20,19,36,17,0.57,1.77
17109,McDonough,il,57,77,20,19,36,17,0.54,2.02
18143,Scott,in,65,85,20,19,36,17,0.16,0.53
29045,Clark,mo,59,78,19,19,36,17,0.41,1.51
47051,Franklin,tn,73,95,22,19,36,17,0.06,0.13
17001,Adams,il,58,78,20,19,36,17,0.43,1.54
21185,Oldham,ky,67,88,21,19,36,17,0.11,0.34
18025,Crawford,in,65,86,21,19,36,17,0.16,0.52
17137,Morgan,il,60,81,21,19,37,18,0.37,1.87
17009,Brown,il,59,80,21,19,37,18,0.41,1.88
21163,Meade,ky,68,89,21,19,37,18,0.16,0.51
18019,Clark,in,69,89,20,19,38,19,0.12,0.39
29063,DeKalb,mo,59,76,17,18,32,14,0.33,0.8
51085,Hanover,va,65,85,20,18,33,15,0.11,0.34
51113,Madison,va,63,82,19,18,33,15,0.15,0.45
31131,Otoe,ne,59,75,16,18,33,15,0.39,0.7
45021,Cherokee,sc,74,95,21,18,34,16,0.09,0.24
37045,Cleveland,nc,73,94,21,18,34,16,0.04,0.17
18175,Washington,in,63,83,20,18,35,17,0.19,0.53
37159,Rowan,nc,75,95,20,18,35,17,0.05,0.25
18101,Martin,in,64,83,19,18,35,17,0.28,0.63
18055,Greene,in,62,81,19,18,35,17,0.33,0.73
18117,Orange,in,63,83,20,18,35,17,0.16,0.53
18093,Lawrence,in,62,82,20,18,35,17,0.29,0.67
18077,Jefferson,in,62,83,21,18,35,17,0.19,0.67
18061,Harrison,in,66,86,20,18,36,18,0.14,0.46
17107,Logan,il,58,79,21,18,37,19,0.4,1.67
17115,Macon,il,60,81,21,18,37,19,0.36,1.57
29211,Sullivan,mo,56,74,18,17,30,13,0.53,1.17
24011,Caroline,md,58,77,19,17,30,13,0.11,0.41
24025,Harford,md,57,76,19,17,30,13,0.17,0.57
31169,Thayer,ne,60,75,15,17,30,13,0.12,0.22
31159,Seward,ne,58,74,16,17,30,13,0.23,0.35
19051,Davis,ia,54,71,17,17,30,13,0.39,0.99
31025,Cass,ne,56,72,16,17,30,13,0.43,0.78
19129,Mills,ia,56,72,16,17,30,13,0.49,0.84
19115,Louisa,ia,52,71,19,17,31,14,0.56,1.8
31151,Saline,ne,60,75,15,17,31,14,0.18,0.28
51685,Manassas Park,va,60,80,20,17,31,14,0.04,0.17
31109,Lancaster,ne,58,74,16,17,31,14,0.23,0.37
51510,Alexandria,va,59,78,19,17,31,14,0.06,0.26
51013,Arlington,va,59,78,19,17,31,14,0.07,0.29
51683,Manassas,va,60,80,20,17,31,14,0.05,0.2
19183,Washington,ia,53,71,18,17,31,14,0.49,1.32
19137,Montgomery,ia,55,71,16,16,29,13,0.52,0.91
29197,Schuyler,mo,53,72,19,16,29,13,0.29,0.83
24029,Kent,md,57,75,18,16,29,13,0.11,0.4
20065,Graham,ks,66,81,15,16,29,13,0.03,0.04
24035,Queen Anne's,md,58,77,19,16,29,13,0.12,0.43
51153,Prince William,va,58,78,20,16,29,13,0.07,0.2
29081,Harrison,mo,55,72,17,16,29,13,0.36,0.81
51610,Falls Church,va,57,77,20,16,29,13,0.04,0.18
19179,Wapello,ia,52,70,18,16,29,13,0.43,1.06
31129,Nuckolls,ne,60,75,15,16,29,13,0.13,0.25
51061,Fauquier,va,58,77,19,16,29,13,0.14,0.41
24041,Talbot,md,59,79,20,16,29,13,0.12,0.37
29001,Adair,mo,55,73,18,16,30,14,0.43,1.13
19139,Muscatine,ia,51,70,19,16,31,15,0.55,1.59
17187,Warren,il,52,73,21,16,31,15,0.48,1.77
37145,Person,nc,67,88,21,16,31,15,0.04,0.33
20057,Ford,ks,71,86,15,16,31,15,0.02,0.05
51810,Virginia Beach,va,60,80,20,16,31,15,0.18,0.66
37157,Rockingham,nc,68,88,20,16,31,15,0.03,0.2
37151,Randolph,nc,71,92,21,16,31,15,0.04,0.25
17071,Henderson,il,53,73,20,16,32,16,0.53,1.76
18071,Jackson,in,60,80,20,16,32,16,0.27,0.65
17113,McLean,il,54,75,21,16,32,16,0.38,1.51
17057,Fulton,il,54,75,21,16,33,17,0.49,2.06
24003,Anne Arundel,md,56,75,19,15,27,12,0.14,0.37
24005,Baltimore,md,55,74,19,15,27,12,0.08,0.32
51107,Loudoun,va,56,76,20,15,27,12,0.08,0.23
24027,Howard,md,54,73,19,15,27,12,0.09,0.27
19125,Marion,ia,50,67,17,15,27,12,0.33,0.74
31021,Burt,ne,53,68,15,15,27,12,0.37,0.63
31181,Webster,ne,59,74,15,15,27,12,0.06,0.16
24033,Prince George's,md,56,75,19,15,28,13,0.13,0.39
24021,Frederick,md,56,75,19,15,28,13,0.06,0.25
51157,Rappahannock,va,58,77,19,15,28,13,0.14,0.36
51003,Albemarle,va,59,79,20,15,28,13,0.09,0.39
51059,Fairfax,va,56,76,20,15,28,13,0.07,0.28
24015,Cecil,md,55,73,18,15,28,13,0.17,0.57
29171,Putnam,mo,53,70,17,15,28,13,0.31,0.83
19103,Johnson,ia,49,68,19,15,28,13,0.46,1.29
31153,Sarpy,ne,54,70,16,15,28,13,0.42,0.77
31065,Furnas,ne,63,78,15,15,28,13,0.02,0.06
31143,Polk,ne,55,72,17,15,28,13,0.18,0.36
19107,Keokuk,ia,50,68,18,15,28,13,0.49,1.24
31155,Saunders,ne,54,70,16,15,28,13,0.26,0.49
29129,Mercer,mo,54,71,17,15,28,13,0.3,0.72
20195,Trego,ks,68,82,14,15,29,14,0.03,0.06
37081,Guilford,nc,68,88,20,15,29,14,0.07,0.18
19057,Des Moines,ia,51,71,20,15,30,15,0.54,1.8
18115,Ohio,in,58,79,21,15,30,15,0.21,0.67
17203,Woodford,il,52,73,21,15,30,15,0.38,1.57
17123,Marshall,il,51,72,21,15,30,15,0.43,1.68
51735,Poquoson,va,58,78,20,15,30,15,0.14,0.44
21077,Gallatin,ky,59,80,21,15,31,16,0.13,0.45
17019,Champaign,il,53,74,21,15,31,16,0.43,1.18
17179,Tazewell,il,52,74,22,15,31,16,0.46,1.94
17039,De Witt,il,55,76,21,15,32,17,0.35,1.57
31125,Nance,ne,53,69,16,14,25,11,0.16,0.31
19117,Lucas,ia,49,66,17,14,26,12,0.29,0.65
31055,Douglas,ne,51,67,16,14,26,12,0.34,0.63
31141,Platte,ne,52,68,16,14,26,12,0.16,0.28
31083,Harlan,ne,60,75,15,14,26,12,0.02,0.05
31121,Merrick,ne,54,71,17,14,26,12,0.17,0.35
19085,Harrison,ia,51,67,16,14,26,12,0.36,0.64
31023,Butler,ne,53,69,16,14,27,13,0.22,0.33
31053,Dodge,ne,53,69,16,14,27,13,0.19,0.37
19173,Taylor,ia,51,68,17,14,27,13,0.39,0.65
20137,Norton,ks,62,77,15,14,27,13,0.02,0.03
19155,Pottawattamie,ia,52,68,16,14,27,13,0.38,0.7
31059,Fillmore,ne,56,72,16,14,27,13,0.11,0.18
39061,Hamilton,oh,56,77,21,14,28,14,0.26,0.73
51089,Henry,va,63,84,21,14,28,14,0.04,0.22
51079,Greene,va,57,77,20,14,28,14,0.05,0.23
51540,Charlottesville,va,58,78,20,14,28,14,0.08,0.31
18029,Dearborn,in,54,75,21,14,28,14,0.25,0.77
17105,Livingston,il,50,70,20,14,28,14,0.42,1.46
17131,Mercer,il,48,68,20,14,29,15,0.55,1.78
51143,Pittsylvania,va,64,85,21,14,29,15,0.11,0.33
18119,Owen,in,54,73,19,14,29,15,0.32,0.73
39017,Butler,oh,55,76,21,14,29,15,0.29,0.81
18005,Bartholomew,in,55,75,20,14,29,15,0.24,0.59
37035,Catawba,nc,66,88,22,14,29,15,0.03,0.17
21081,Grant,ky,58,80,22,14,29,15,0.11,0.38
51690,Martinsville,va,65,86,21,14,29,15,0.03,0.19
21005,Anderson,ky,61,83,22,14,30,16,0.07,0.28
21167,Mercer,ky,61,84,23,14,30,16,0.07,0.21
13083,Dade,ga,62,85,23,14,30,16,0.02,0.12
21073,Franklin,ky,60,81,21,14,30,16,0.07,0.27
17143,Peoria,il,50,72,22,14,30,16,0.44,1.94
46027,Clay,sd,49,64,15,13,23,10,0.29,0.48
19175,Union,ia,47,64,17,13,24,11,0.25,0.52
34015,Gloucester,nj,49,67,18,13,24,11,0.08,0.34
19003,Adams,ia,48,65,17,13,24,11,0.44,0.73
6077,San Joaquin,ca,69,89,20,13,24,11,0.02,0.01
19159,Ringgold,ia,48,65,17,13,24,11,0.29,0.56
31037,Colfax,ne,50,66,16,13,24,11,0.18,0.32
19185,Wayne,ia,47,64,17,13,24,11,0.26,0.59
19133,Monona,ia,49,65,16,13,24,11,0.37,0.64
19153,Polk,ia,46,63,17,13,24,11,0.26,0.59
19121,Madison,ia,47,64,17,13,24,11,0.23,0.54
19031,Cedar,ia,44,62,18,13,24,11,0.36,1.13
51125,Nelson,va,55,75,20,13,25,12,0.11,0.4
24031,Montgomery,md,52,71,19,13,25,12,0.13,0.38
31177,Washington,ne,50,66,16,13,25,12,0.29,0.54
19099,Jasper,ia,46,63,17,13,25,12,0.35,0.8
31173,Thurston,ne,50,66,16,13,25,12,0.33,0.51
31061,Franklin,ne,57,72,15,13,25,12,0.03,0.14
17161,Rock Island,il,45,65,20,13,26,13,0.54,1.57
19163,Scott,ia,45,64,19,13,26,13,0.36,1.23
17155,Putnam,il,47,67,20,13,26,13,0.39,1.53
17075,Iroquois,il,49,69,20,13,27,14,0.37,1.02
24039,Somerset,md,58,78,20,13,27,14,0.06,0.25
51011,Appomattox,va,59,80,21,13,27,14,0.08,0.36
13057,Cherokee,ga,68,92,24,13,27,14,0.03,0.14
18045,Fountain,in,51,70,19,13,27,14,0.43,1.07
17095,Knox,il,46,67,21,13,27,14,0.41,1.72
51009,Amherst,va,59,80,21,13,27,14,0.09,0.38
17053,Ford,il,50,70,20,13,28,15,0.36,1.09
21037,Campbell,ky,55,77,22,13,28,15,0.13,0.43
18013,Brown,in,54,74,20,13,28,15,0.28,0.7
13143,Haralson,ga,71,95,24,13,29,16,0.02,0.12
46009,Bon Homme,sd,46,62,16,12,21,9,0.25,0.41
31015,Boyd,ne,46,61,15,12,21,9,0.14,0.24
31043,Dakota,ne,46,62,16,12,22,10,0.26,0.42
19015,Boone,ia,43,60,17,12,22,10,0.36,0.81
24013,Carroll,md,48,67,19,12,22,10,0.04,0.24
54037,Jefferson,wv,52,71,19,12,23,11,0.07,0.16
19009,Audubon,ia,46,62,16,12,23,11,0.31,0.58
19113,Linn,ia,43,61,18,12,23,11,0.31,0.99
10003,New Castle,de,49,67,18,12,23,11,0.11,0.33
19049,Dallas,ia,45,62,17,12,23,11,0.27,0.59
19073,Greene,ia,46,63,17,12,23,11,0.37,0.78
19077,Guthrie,ia,46,62,16,12,23,11,0.24,0.53
31039,Cuming,ne,48,63,15,12,23,11,0.27,0.41
17195,Whiteside,il,42,62,20,12,23,11,0.36,1.46
17063,Grundy,il,44,63,19,12,24,12,0.34,1.16
31081,Hamilton,ne,52,68,16,12,24,12,0.14,0.35
24009,Calvert,md,53,72,19,12,24,12,0.06,0.34
19157,Poweshiek,ia,44,61,17,12,24,12,0.31,0.89
37111,McDowell,nc,61,83,22,12,25,13,0.05,0.14
51031,Campbell,va,57,78,21,12,25,13,0.13,0.37
17011,Bureau,il,44,65,21,12,25,13,0.35,1.41
20101,Lane,ks,67,82,15,12,25,13,0,0.02
54011,Cabell,wv,56,78,22,12,25,13,0.06,0.19
37197,Yadkin,nc,62,84,22,12,25,13,0.02,0.08
21239,Woodford,ky,56,78,22,12,26,14,0.07,0.22
17175,Stark,il,45,66,21,12,26,14,0.41,1.63
20069,Gray,ks,68,83,15,12,26,14,0.01,0.03
17073,Henry,il,44,65,21,12,26,14,0.37,1.52
21019,Boyd,ky,56,78,22,12,26,14,0.03,0.16
21173,Montgomery,ky,57,78,21,12,27,15,0.06,0.19
46017,Buffalo,sd,43,56,13,11,18,7,0.09,0.12
46075,Jones,sd,48,61,13,11,19,8,0.04,0.06
46061,Hanson,sd,43,57,14,11,19,8,0.14,0.21
46067,Hutchinson,sd,44,59,15,11,20,9,0.17,0.3
31027,Cedar,ne,44,60,16,11,20,9,0.22,0.42
17197,Will,il,42,60,18,11,21,10,0.34,0.96
31167,Stanton,ne,46,62,16,11,21,10,0.25,0.4
17015,Carroll,il,39,58,19,11,21,10,0.27,1.15
19127,Marshall,ia,41,58,17,11,21,10,0.35,0.81
19169,Story,ia,41,58,17,11,21,10,0.3,0.68
31051,Dixon,ne,45,61,16,11,21,10,0.28,0.47
31119,Madison,ne,45,61,16,11,21,10,0.17,0.27
19193,Woodbury,ia,45,61,16,11,21,10,0.34,0.57
17093,Kendall,il,40,59,19,11,21,10,0.22,0.77
19045,Clinton,ia,41,60,19,11,22,11,0.32,1.19
10001,Kent,de,49,68,19,11,22,11,0.09,0.36
19165,Shelby,ia,46,62,16,11,22,11,0.26,0.51
19171,Tama,ia,41,58,17,11,22,11,0.31,0.82
31093,Howard,ne,50,66,16,11,22,11,0.08,0.21
31139,Pierce,ne,46,62,16,11,22,11,0.18,0.24
19011,Benton,ia,42,59,17,11,22,11,0.3,0.94
31099,Kearney,ne,54,70,16,11,22,11,0.04,0.08
31001,Adams,ne,53,68,15,11,22,11,0.04,0.14
31011,Boone,ne,47,63,16,11,22,11,0.13,0.23
34011,Cumberland,nj,47,65,18,11,22,11,0.06,0.33
54003,Berkeley,wv,51,70,19,11,23,12,0.06,0.14
18157,Tippecanoe,in,47,67,20,11,23,12,0.34,0.8
18111,Newton,in,45,64,19,11,23,12,0.34,0.91
20063,Gove,ks,63,77,14,11,23,12,0.02,0.02
31035,Clay,ne,52,67,15,11,23,12,0.08,0.18
18015,Carroll,in,46,66,20,11,23,12,0.28,0.71
17099,LaSalle,il,43,63,20,11,23,12,0.43,1.54
31079,Hall,ne,51,68,17,11,23,12,0.08,0.21
37027,Caldwell,nc,60,82,22,11,24,13,0.02,0.08
10005,Sussex,de,52,72,20,11,24,13,0.14,0.62
21159,Martin,ky,55,77,22,11,24,13,0.08,0.22
20067,Grant,ks,71,86,15,11,24,13,0.01,0.01
39025,Clermont,oh,50,71,21,11,24,13,0.16,0.52
39053,Gallia,oh,54,75,21,11,24,13,0.12,0.27
20171,Scott,ks,66,81,15,11,24,13,0,0.02
18137,Ripley,in,49,69,20,11,24,13,0.23,0.72
51680,Lynchburg,va,56,77,21,11,24,13,0.07,0.26
20081,Haskell,ks,69,85,16,11,24,13,0.01,0.02
20179,Sheridan,ks,62,77,15,11,24,13,0.01,0.01
39145,Scioto,oh,54,75,21,11,24,13,0.1,0.22
21023,Bracken,ky,52,73,21,11,24,13,0.03,0.23
21071,Floyd,ky,56,79,23,11,25,14,0.04,0.21
21067,Fayette,ky,55,76,21,11,25,14,0.03,0.17
18109,Morgan,in,49,69,20,11,25,14,0.26,0.59
21127,Lawrence,ky,56,78,22,11,25,14,0.04,0.19
21015,Boone,ky,51,72,21,11,25,14,0.22,0.71
48393,Roberts,tx,73,89,16,11,25,14,0.03,0.06
46095,Mellette,sd,48,61,13,10,18,8,0.04,0.06
46111,Sanborn,sd,41,54,13,10,18,8,0.19,0.27
46035,Davison,sd,41,55,14,10,18,8,0.15,0.21
46123,Tripp,sd,46,60,14,10,19,9,0.07,0.08
19079,Hamilton,ia,39,56,17,10,19,9,0.28,0.59
46135,Yankton,sd,43,58,15,10,19,9,0.17,0.29
46053,Gregory,sd,44,59,15,10,19,9,0.15,0.24
24043,Washington,md,48,66,18,10,20,10,0.03,0.15
51187,Warren,va,48,67,19,10,20,10,0.08,0.24
19027,Carroll,ia,43,59,16,10,20,10,0.32,0.64
6043,Mariposa,ca,61,78,17,10,20,10,0.02,0.03
19047,Crawford,ia,42,58,16,10,20,10,0.28,0.54
31179,Wayne,ne,44,60,16,10,20,10,0.21,0.36
19149,Plymouth,ia,42,58,16,10,20,10,0.29,0.48
18017,Cass,in,42,61,19,10,21,11,0.3,0.73
18181,White,in,45,64,19,10,22,12,0.3,0.72
37169,Stokes,nc,57,78,21,10,22,12,0.02,0.13
54035,Jackson,wv,52,73,21,10,22,12,0.09,0.23
20093,Kearny,ks,67,82,15,10,22,12,0,0.02
18057,Hamilton,in,45,65,20,10,22,12,0.26,0.62
18011,Boone,in,46,66,20,10,22,12,0.24,0.58
18063,Hendricks,in,46,66,20,10,22,12,0.3,0.64
54053,Mason,wv,52,73,21,10,22,12,0.12,0.26
51770,Roanoke,va,54,76,22,10,22,12,0.02,0.16
51001,Accomack,va,52,71,19,10,22,12,0.07,0.21
51019,Bedford,va,54,76,22,10,23,13,0.06,0.27
54043,Lincoln,wv,53,75,22,10,23,13,0.06,0.17
21043,Carter,ky,53,74,21,10,23,13,0.04,0.13
21063,Elliott,ky,54,75,21,10,23,13,0.04,0.16
21135,Lewis,ky,52,73,21,10,23,13,0.06,0.17
21175,Morgan,ky,55,77,22,10,23,13,0.04,0.16
24047,Worcester,md,49,69,20,10,23,13,0.08,0.54
18007,Benton,in,45,65,20,10,23,13,0.32,0.83
18097,Marion,in,46,66,20,10,23,13,0.26,0.54
39165,Warren,oh,48,69,21,10,23,13,0.21,0.56
18059,Hancock,in,46,66,20,10,23,13,0.27,0.56
54079,Putnam,wv,52,74,22,10,23,13,0.07,0.22
18107,Montgomery,in,47,66,19,10,23,13,0.39,0.86
18047,Franklin,in,48,68,20,10,23,13,0.24,0.73
39113,Montgomery,oh,46,67,21,10,23,13,0.21,0.57
21069,Fleming,ky,53,75,22,10,24,14,0.03,0.19
47155,Sevier,tn,57,80,23,10,24,14,0.02,0.08
21147,McCreary,ky,56,79,23,10,24,14,0.02,0.12
47129,Morgan,tn,56,80,24,10,24,14,0.03,0.19
54099,Wayne,wv,54,76,22,10,24,14,0.06,0.15
18031,Decatur,in,48,69,21,10,24,14,0.21,0.49
47059,Greene,tn,59,82,23,10,24,14,0.01,0.08
21161,Mason,ky,52,73,21,10,24,14,0.03,0.22
18081,Johnson,in,47,68,21,10,24,14,0.25,0.6
48141,El Paso,tx,95,117,22,10,30,20,0.12,0.63
6009,Calaveras,ca,55,72,17,9,18,9,0.01,0.02
46125,Turner,sd,40,55,15,9,18,9,0.22,0.35
31183,Wheeler,ne,43,59,16,9,18,9,0.08,0.13
31003,Antelope,ne,43,58,15,9,19,10,0.19,0.26
31077,Greeley,ne,45,61,16,9,19,10,0.07,0.13
13137,Habersham,ga,55,79,24,9,20,11,0.01,0.08
54107,Wood,wv,47,68,21,9,20,11,0.07,0.17
31145,Red Willow,ne,55,71,16,9,20,11,0.01,0.02
39141,Ross,oh,45,66,21,9,20,11,0.11,0.34
18067,Howard,in,43,62,19,9,21,12,0.24,0.59
54039,Kanawha,wv,50,72,22,9,21,12,0.06,0.15
51067,Franklin,va,53,74,21,9,21,12,0.03,0.21
54059,Mingo,wv,51,73,22,9,21,12,0.09,0.24
39163,Vinton,oh,47,68,21,9,21,12,0.09,0.26
39131,Pike,oh,49,70,21,9,21,12,0.11,0.22
13085,Dawson,ga,56,80,24,9,21,12,0.01,0.06
39001,Adams,oh,49,70,21,9,21,12,0.05,0.17
39057,Greene,oh,45,65,20,9,21,12,0.17,0.48
39015,Brown,oh,46,67,21,9,21,12,0.09,0.33
51775,Salem,va,53,74,21,9,21,12,0.02,0.13
21189,Owsley,ky,53,75,22,9,22,13,0.02,0.09
21025,Breathitt,ky,53,75,22,9,22,13,0.02,0.09
21153,Magoffin,ky,53,75,22,9,22,13,0.04,0.16
48165,Gaines,tx,88,107,19,9,23,14,0,0.01
47061,Grundy,tn,52,75,23,9,23,14,0.03,0.09
47073,Hawkins,tn,60,84,24,9,24,15,0.01,0.06
39039,Defiance,oh,37,56,19,8,17,9,0.08,0.42
18033,DeKalb,in,37,56,19,8,17,9,0.09,0.43
18003,Allen,in,37,56,19,8,18,10,0.12,0.46
31137,Phelps,ne,49,64,15,8,18,10,0.01,0.06
39107,Mercer,oh,39,59,20,8,18,10,0.16,0.48
39049,Franklin,oh,41,62,21,8,18,10,0.12,0.34
20153,Rawlins,ks,56,71,15,8,19,11,0.01,0.02
18161,Union,in,42,62,20,8,19,11,0.21,0.55
39109,Miami,oh,41,61,20,8,19,11,0.15,0.5
13123,Gilmer,ga,53,77,24,8,20,12,0.02,0.09
20109,Logan,ks,60,75,15,8,20,12,0.01,0.02
18139,Rush,in,43,63,20,8,20,12,0.26,0.52
21121,Knox,ky,52,75,23,8,20,12,0.01,0.11
47151,Scott,tn,50,73,23,8,21,13,0.02,0.12
21235,Whitley,ky,52,75,23,8,21,13,0.01,0.09
20187,Stanton,ks,69,85,16,8,21,13,0,0.01
48107,Crosby,tx,79,97,18,8,23,15,0.01,0.03
4025,Yavapai,az,50,66,16,7,12,5,0.09,0.29
6033,Lake,ca,48,64,16,7,13,6,0.01,0
17097,Lake,il,27,42,15,7,13,6,0.16,0.52
26149,St. Joseph,mi,33,50,17,7,14,7,0.15,0.43
27033,Cottonwood,mn,32,46,14,7,14,7,0.14,0.32
27131,Rice,mn,31,45,14,7,14,7,0.18,0.45
24001,Allegany,md,37,56,19,7,15,8,0.04,0.15
54065,Morgan,wv,40,59,19,7,15,8,0.03,0.11
18091,LaPorte,in,33,50,17,7,15,8,0.22,0.54
19189,Winnebago,ia,32,48,16,7,15,8,0.12,0.37
26027,Cass,mi,34,51,17,7,15,8,0.24,0.53
39147,Seneca,oh,34,53,19,7,15,8,0.09,0.28
27043,Faribault,mn,32,47,15,7,15,8,0.14,0.36
18141,St. Joseph,in,34,51,17,7,15,8,0.18,0.51
26021,Berrien,mi,32,48,16,7,15,8,0.24,0.53
18113,Noble,in,33,51,18,7,15,8,0.11,0.42
31073,Gosper,ne,46,62,16,7,15,8,0.01,0.02
51015,Augusta,va,42,62,20,7,16,9,0.08,0.31
39137,Putnam,oh,36,55,19,7,16,9,0.11,0.36
39175,Wyandot,oh,36,55,19,7,16,9,0.07,0.32
18085,Kosciusko,in,34,52,18,7,16,9,0.28,0.74
39171,Williams,oh,36,54,18,7,16,9,0.08,0.4
31071,Garfield,ne,41,57,16,7,16,9,0.03,0.11
19109,Kossuth,ia,34,50,16,7,16,9,0.24,0.48
39069,Henry,oh,36,55,19,7,16,9,0.09,0.33
18183,Whitley,in,34,52,18,7,16,9,0.18,0.58
39125,Paulding,oh,37,56,19,7,17,10,0.09,0.42
18009,Blackford,in,36,56,20,7,17,10,0.22,0.52
51023,Botetourt,va,46,67,21,7,17,10,0.04,0.21
18179,Wells,in,37,56,19,7,17,10,0.15,0.48
54057,Mineral,wv,42,61,19,7,17,10,0.04,0.15
18065,Henry,in,37,57,20,7,17,10,0.24,0.56
51580,Covington,va,45,66,21,7,17,10,0.03,0.12
39071,Highland,oh,40,61,21,7,17,10,0.07,0.26
39065,Hardin,oh,37,56,19,7,17,10,0.09,0.33
39023,Clark,oh,38,57,19,7,17,10,0.16,0.47
39041,Delaware,oh,39,59,20,7,17,10,0.09,0.33
51820,Waynesboro,va,42,62,20,7,17,10,0.08,0.31
39149,Shelby,oh,36,56,20,7,17,10,0.14,0.44
39045,Fairfield,oh,40,61,21,7,17,10,0.06,0.24
39021,Champaign,oh,37,56,19,7,17,10,0.12,0.42
54013,Calhoun,wv,46,67,21,7,18,11,0.07,0.12
51141,Patrick,va,48,69,21,7,18,11,0.03,0.19
39167,Washington,oh,44,65,21,7,18,11,0.06,0.14
18075,Jay,in,38,57,19,7,18,11,0.23,0.6
18177,Wayne,in,39,59,20,7,18,11,0.23,0.58
39159,Union,oh,39,59,20,7,18,11,0.09,0.34
39009,Athens,oh,44,64,20,7,18,11,0.07,0.23
39097,Madison,oh,41,61,20,7,18,11,0.09,0.34
13187,Lumpkin,ga,52,77,25,7,18,11,0.01,0.06
48233,Hutchinson,tx,71,88,17,7,18,11,0.03,0.02
39027,Clinton,oh,40,61,21,7,18,11,0.11,0.36
20129,Morton,ks,67,82,15,7,18,11,0.01,0.01
13227,Pickens,ga,51,75,24,7,18,11,0.02,0.09
39003,Allen,oh,37,57,20,7,18,11,0.12,0.38
39011,Auglaize,oh,37,57,20,7,18,11,0.13,0.4
54045,Logan,wv,46,68,22,7,19,12,0.06,0.15
39135,Preble,oh,40,61,21,7,19,12,0.21,0.58
35025,Lea,nm,83,103,20,7,19,12,0,0.01
20075,Hamilton,ks,65,82,17,7,19,12,0.01,0.02
21125,Laurel,ky,51,73,22,7,20,13,0.02,0.12
48305,Lynn,tx,81,100,19,7,20,13,0.02,0.02
47067,Hancock,tn,53,76,23,7,20,13,0.01,0.05
35013,Do��a Ana,nm,85,110,25,7,23,16,0.12,0.64
27127,Redwood,mn,32,46,14,6,13,7,0.15,0.2
36061,New York,ny,31,48,17,6,13,7,0.01,0.06
53021,Franklin,wa,37,51,14,6,13,7,0,0.01
26023,Branch,mi,30,47,17,6,13,7,0.13,0.49
19143,Osceola,ia,32,46,14,6,13,7,0.28,0.42
19059,Dickinson,ia,32,46,14,6,13,7,0.2,0.33
27091,Martin,mn,31,46,15,6,14,8,0.13,0.26
34031,Passaic,nj,33,50,17,6,14,8,0.02,0.06
31047,Dawson,ne,45,60,15,6,14,8,0.02,0.04
26077,Kalamazoo,mi,33,49,16,6,14,8,0.15,0.39
31115,Loup,ne,40,55,15,6,14,8,0.01,0.06
19063,Emmet,ia,32,47,15,6,14,8,0.19,0.33
39063,Hancock,oh,33,52,19,6,14,8,0.1,0.31
18087,LaGrange,in,31,48,17,6,14,8,0.09,0.39
51005,Alleghany,va,40,61,21,6,15,9,0.04,0.19
54041,Lewis,wv,40,62,22,6,15,9,0.04,0.06
39089,Licking,oh,36,56,20,6,15,9,0.08,0.29
39051,Fulton,oh,35,53,18,6,15,9,0.07,0.33
51530,Buena Vista,va,41,61,20,6,15,9,0.06,0.28
39173,Wood,oh,35,53,18,6,15,9,0.08,0.25
31057,Dundy,ne,53,68,15,6,15,9,0.01,0.02
37039,Cherokee,nc,46,69,23,6,16,10,0.01,0.05
54005,Boone,wv,42,64,22,6,16,10,0.04,0.14
21193,Perry,ky,45,67,22,6,16,10,0.02,0.07
47163,Sullivan,tn,50,73,23,6,16,10,0,0.04
37193,Wilkes,nc,49,70,21,6,16,10,0.02,0.07
54007,Braxton,wv,42,64,22,6,16,10,0.03,0.04
54085,Ritchie,wv,41,62,21,6,16,10,0.08,0.12
4023,Santa Cruz,az,82,103,21,6,16,10,0,0.01
54073,Pleasants,wv,39,60,21,6,16,10,0.04,0.08
39073,Hocking,oh,41,62,21,6,16,10,0.07,0.2
20193,Thomas,ks,54,69,15,6,16,10,0.01,0.01
39091,Logan,oh,35,54,19,6,16,10,0.11,0.32
35005,Chaves,nm,81,101,20,6,16,10,0,0.02
35023,Hidalgo,nm,77,100,23,6,16,10,0.01,0.09
18135,Randolph,in,35,55,20,6,16,10,0.23,0.61
39101,Marion,oh,35,54,19,6,16,10,0.07,0.34
54021,Gilmer,wv,43,65,22,6,17,11,0.06,0.07
39047,Fayette,oh,39,59,20,6,17,11,0.09,0.28
13311,White,ga,50,74,24,6,17,11,0,0.03
48109,Culberson,tx,82,103,21,6,17,11,0.01,0.04
47035,Cumberland,tn,44,67,23,6,17,11,0.03,0.19
20203,Wichita,ks,59,75,16,6,17,11,0,0.01
13111,Fannin,ga,50,74,24,6,17,11,0.02,0.09
48303,Lubbock,tx,77,97,20,6,17,11,0,0.01
39037,Darke,oh,36,56,20,6,17,11,0.18,0.46
48153,Floyd,tx,73,92,19,6,19,13,0.01,0.06
53005,Benton,wa,34,48,14,5,11,6,0,0.01
6095,Solano,ca,37,54,17,5,11,6,0.02,0.01
53003,Asotin,wa,33,45,12,5,11,6,0,0
6017,El Dorado,ca,39,53,14,5,11,6,0.02,0.01
39143,Sandusky,oh,31,49,18,5,13,8,0.07,0.23
48011,Armstrong,tx,63,82,19,5,14,9,0.03,0.08
54015,Clay,wv,40,62,22,5,15,10,0.02,0.04
48445,Terry,tx,78,98,20,5,16,11,0.02,0.02
30021,Dawson,mt,29,40,11,4,8,4,0,0.01
53071,Walla Walla,wa,32,45,13,4,9,5,0,0.01
46102,Oglala Lakota,sd,41,54,13,4,10,6,0.01,0.02
37089,Henderson,nc,38,59,21,4,11,7,0.02,0.06
31029,Chase,ne,46,61,15,4,11,7,0,0.01
4003,Cochise,az,74,96,22,4,11,7,0.01,0.02
41045,Malheur,or,42,55,13,4,11,7,0,0.01
16075,Payette,id,47,60,13,4,12,8,0,0
20071,Greeley,ks,55,71,16,4,13,9,0,0.01
48219,Hockley,tx,74,94,20,4,14,10,0,0.01
41065,Wasco,or,24,35,11,3,6,3,0.02,0.02
6055,Napa,ca,29,45,16,3,7,4,0.02,0.01
36059,Nassau,ny,23,38,15,3,7,4,0,0.04
41059,Umatilla,or,28,40,12,3,7,4,0,0.01
31091,Hooker,ne,36,51,15,3,8,5,0.01,0.01
16069,Nez Perce,id,29,41,12,3,8,5,0,0
46007,Bennett,sd,37,50,13,3,8,5,0.02,0.02
31031,Cherry,ne,36,50,14,3,9,6,0.04,0.03
39139,Richland,oh,24,42,18,3,9,6,0.07,0.17
31117,McPherson,ne,37,52,15,3,9,6,0,0.01
42129,Westmoreland,pa,27,45,18,3,9,6,0.02,0.06
54009,Brooke,wv,29,47,18,3,10,7,0.01,0.04
31135,Perkins,ne,44,59,15,3,10,7,0.01,0.01
13291,Union,ga,37,60,23,3,11,8,0.01,0.04
51520,Bristol,va,41,65,24,3,11,8,0,0.01
36057,Montgomery,ny,19,33,14,2,6,4,0.01,0.02
9011,New London,ct,18,32,14,2,7,5,0.01,0.07
9015,Windham,ct,19,32,13,2,7,5,0.01,0.06
24510,Baltimore,md,55,74,19,15,26,11,0.04,0.23
24017,Charles,md,56,76,20,15,27,12,0.17,0.7
46043,Douglas,sd,49,63,14,14,23,9,0.17,0.23
34007,Camden,nj,51,69,18,14,25,11,0.1,0.38
34005,Burlington,nj,50,68,18,14,25,11,0.12,0.42
42101,Philadelphia,pa,51,69,18,14,25,11,0.1,0.29
19007,Appanoose,ia,49,66,17,14,26,12,0.29,0.7
19135,Monroe,ia,49,66,17,14,26,12,0.34,0.72
19181,Warren,ia,48,65,17,14,26,12,0.26,0.66
51600,Fairfax,va,53,73,20,14,26,12,0.03,0.14
19123,Mahaska,ia,48,66,18,14,26,12,0.31,0.77
46023,Charles Mix,sd,48,62,14,13,22,9,0.21,0.35
42045,Delaware,pa,49,67,18,13,24,11,0.08,0.23
34033,Salem,nj,50,68,18,13,24,11,0.08,0.33
19095,Iowa,ia,46,64,18,13,25,12,0.34,0.95
19053,Decatur,ia,49,66,17,13,25,12,0.25,0.58
19039,Clarke,ia,48,65,17,13,25,12,0.25,0.53
17091,Kankakee,il,48,67,19,13,26,13,0.39,1.08
46015,Brule,sd,45,59,14,12,20,8,0.1,0.12
46085,Lyman,sd,48,62,14,12,21,9,0.08,0.08
46003,Aurora,sd,45,59,14,12,21,9,0.11,0.16
31107,Knox,ne,47,62,15,12,22,10,0.24,0.36
18171,Warren,in,50,69,19,12,26,14,0.41,1.07
46065,Hughes,sd,46,59,13,11,19,8,0.06,0.06
19105,Jones,ia,39,56,17,11,20,9,0.31,1.01
46127,Union,sd,44,60,16,11,21,10,0.24,0.39
17043,DuPage,il,41,59,18,11,21,10,0.22,0.73
17007,Boone,il,36,53,17,10,18,8,0.25,0.71
55105,Rock,wi,35,51,16,10,18,8,0.28,0.79
55127,Walworth,wi,36,51,15,10,18,8,0.24,0.78
17089,Kane,il,37,54,17,10,18,8,0.21,0.71
19083,Hardin,ia,38,55,17,10,19,9,0.33,0.8
42091,Montgomery,pa,43,61,18,10,19,9,0.07,0.22
34021,Mercer,nj,42,60,18,10,19,9,0.04,0.13
42133,York,pa,44,62,18,10,19,9,0.12,0.46
42017,Bucks,pa,43,61,18,10,19,9,0.08,0.23
19097,Jackson,ia,36,54,18,10,19,9,0.26,1.08
42001,Adams,pa,45,63,18,10,19,9,0.03,0.15
18073,Jasper,in,42,61,19,10,20,10,0.33,0.78
19023,Butler,ia,39,56,17,10,20,10,0.29,0.88
17141,Ogle,il,37,56,19,10,20,10,0.32,0.98
17103,Lee,il,37,57,20,10,20,10,0.34,1.27
18089,Lake,in,40,58,18,10,20,10,0.27,0.76
51043,Clarke,va,48,67,19,10,21,11,0.08,0.24
46069,Hyde,sd,39,52,13,9,15,6,0.04,0.07
17111,McHenry,il,33,49,16,9,16,7,0.22,0.68
55055,Jefferson,wi,34,48,14,9,16,7,0.28,0.73
34023,Middlesex,nj,39,56,17,9,17,8,0.01,0.13
46073,Jerauld,sd,40,53,13,9,17,8,0.13,0.13
42071,Lancaster,pa,41,59,18,9,17,8,0.2,0.54
34035,Somerset,nj,39,57,18,9,18,9,0.02,0.14
19017,Bremer,ia,36,53,17,9,18,9,0.24,0.76
17177,Stephenson,il,34,52,18,9,18,9,0.24,0.88
31089,Holt,ne,43,57,14,9,18,9,0.14,0.22
19167,Sioux,ia,39,55,16,9,18,9,0.33,0.47
19061,Dubuque,ia,35,52,17,9,18,9,0.32,0.78
19019,Buchanan,ia,36,53,17,9,18,9,0.23,0.81
34039,Union,nj,40,58,18,9,18,9,0.02,0.14
19093,Ida,ia,40,56,16,9,18,9,0.22,0.41
17201,Winnebago,il,35,52,17,9,18,9,0.25,0.72
31019,Buffalo,ne,48,64,16,9,18,9,0.05,0.14
17037,DeKalb,il,36,53,17,9,18,9,0.26,0.79
19075,Grundy,ia,38,54,16,9,19,10,0.33,0.77
18099,Marshall,in,39,57,18,9,19,10,0.27,0.69
19025,Calhoun,ia,40,57,17,9,19,10,0.28,0.57
19187,Webster,ia,39,55,16,9,19,10,0.3,0.62
18131,Pulaski,in,40,59,19,9,19,10,0.31,0.72
19067,Floyd,ia,37,53,16,9,19,10,0.33,0.88
19013,Black Hawk,ia,38,55,17,9,19,10,0.23,0.81
18149,Starke,in,40,58,18,9,19,10,0.26,0.69
18169,Wabash,in,39,58,19,9,19,10,0.27,0.74
18103,Miami,in,41,60,19,9,20,11,0.28,0.73
51069,Frederick,va,47,67,20,9,20,11,0.06,0.19
39105,Meigs,oh,49,70,21,9,20,11,0.12,0.23
18069,Huntington,in,41,60,19,9,20,11,0.19,0.6
39079,Jackson,oh,48,69,21,9,20,11,0.09,0.21
18023,Clinton,in,43,62,19,9,20,11,0.24,0.54
51840,Winchester,va,48,67,19,9,20,11,0.04,0.1
54105,Wirt,wv,49,70,21,9,21,12,0.11,0.16
46049,Faulk,sd,35,46,11,8,13,5,0.05,0.14
46115,Spink,sd,34,46,12,8,13,5,0.06,0.12
31103,Keya Paha,ne,41,56,15,8,15,7,0.06,0.08
34019,Hunterdon,nj,37,54,17,8,15,7,0.03,0.09
46005,Beadle,sd,36,49,13,8,15,7,0.12,0.21
46087,McCook,sd,36,50,14,8,15,7,0.11,0.15
55065,Lafayette,wi,31,47,16,8,15,7,0.26,0.59
46083,Lincoln,sd,36,51,15,8,15,7,0.23,0.36
34013,Essex,nj,36,53,17,8,16,8,0.02,0.1
17031,Cook,il,35,51,16,8,16,8,0.2,0.61
34001,Atlantic,nj,35,53,18,8,16,8,0.09,0.36
55043,Grant,wi,32,48,16,8,16,8,0.34,0.74
46071,Jackson,sd,47,59,12,8,16,8,0.04,0.03
42043,Dauphin,pa,39,57,18,8,16,8,0.04,0.19
46055,Haakon,sd,44,57,13,8,16,8,0.04,0.05
19141,O'Brien,ia,37,52,15,8,16,8,0.29,0.45
19055,Delaware,ia,33,50,17,8,16,8,0.22,0.78
18127,Porter,in,36,53,17,8,16,8,0.22,0.52
55045,Green,wi,32,48,16,8,16,8,0.24,0.59
19119,Lyon,ia,37,52,15,8,16,8,0.28,0.42
27165,Watonwan,mn,34,49,15,8,16,8,0.16,0.34
42029,Chester,pa,40,58,18,8,17,9,0.19,0.54
42041,Cumberland,pa,41,59,18,8,17,9,0.02,0.09
39095,Lucas,oh,36,55,19,8,17,9,0.09,0.31
19035,Cherokee,ia,38,53,15,8,17,9,0.24,0.39
51171,Shenandoah,va,44,63,19,8,17,9,0.04,0.17
19197,Wright,ia,35,52,17,8,17,9,0.22,0.48
19161,Sac,ia,38,54,16,8,17,9,0.28,0.58
19043,Clayton,ia,34,50,16,8,17,9,0.36,0.76
17085,Jo Daviess,il,33,50,17,8,17,9,0.26,1
31175,Valley,ne,43,58,15,8,17,9,0.03,0.09
19037,Chickasaw,ia,34,50,16,8,17,9,0.29,0.8
18039,Elkhart,in,36,54,18,8,17,9,0.17,0.51
31163,Sherman,ne,45,61,16,8,17,9,0.05,0.12
31063,Frontier,ne,50,66,16,8,17,9,0.01,0.02
19151,Pocahontas,ia,37,54,17,8,17,9,0.24,0.41
19091,Humboldt,ia,36,52,16,8,17,9,0.22,0.48
51139,Page,va,43,62,19,8,17,9,0.03,0.12
51165,Rockingham,va,45,65,20,8,18,10,0.04,0.18
18049,Fulton,in,38,56,18,8,18,10,0.29,0.74
19069,Franklin,ia,36,52,16,8,18,10,0.26,0.78
18035,Delaware,in,40,60,20,8,19,11,0.25,0.61
51790,Staunton,va,46,67,21,8,19,11,0.06,0.19
18001,Adams,in,39,59,20,8,19,11,0.13,0.52
31087,Hitchcock,ne,54,69,15,8,19,11,0.01,0.03
39161,Van Wert,oh,40,59,19,8,19,11,0.11,0.48
18159,Tipton,in,41,61,20,8,20,12,0.25,0.61
54087,Roane,wv,48,70,22,8,20,12,0.06,0.12
18053,Grant,in,40,60,20,8,20,12,0.23,0.53
18095,Madison,in,42,62,20,8,20,12,0.27,0.62
39129,Pickaway,oh,44,65,21,8,20,12,0.11,0.33
51163,Rockbridge,va,48,69,21,8,20,12,0.07,0.28
46013,Brown,sd,31,41,10,7,11,4,0.1,0.12
27023,Chippewa,mn,31,43,12,7,12,5,0.14,0.38
55077,Marquette,wi,29,41,12,7,12,5,0.21,0.47
55047,Green Lake,wi,28,40,12,7,12,5,0.22,0.49
27129,Renville,mn,32,45,13,7,13,6,0.15,0.22
27163,Washington,mn,30,43,13,7,13,6,0.26,0.49
55111,Sauk,wi,29,42,13,7,13,6,0.23,0.46
55025,Dane,wi,29,43,14,7,13,6,0.27,0.65
55021,Columbia,wi,30,44,14,7,13,6,0.22,0.49
27123,Ramsey,mn,31,45,14,7,13,6,0.23,0.41
55027,Dodge,wi,29,42,13,7,13,6,0.26,0.69
55103,Richland,wi,30,44,14,7,13,6,0.23,0.49
27003,Anoka,mn,30,43,13,7,13,6,0.24,0.39
34003,Bergen,nj,34,50,16,7,14,7,0.02,0.07
27013,Blue Earth,mn,32,47,15,7,14,7,0.19,0.51
27161,Waseca,mn,31,45,14,7,14,7,0.15,0.37
19195,Worth,ia,30,46,16,7,14,7,0.19,0.62
4007,Gila,az,58,75,17,7,14,7,0.07,0.16
42055,Franklin,pa,38,56,18,7,14,7,0.03,0.09
27157,Wabasha,mn,31,45,14,7,14,7,0.22,0.44
46097,Miner,sd,34,47,13,7,14,7,0.14,0.22
42075,Lebanon,pa,36,54,18,7,14,7,0.04,0.19
42119,Union,pa,36,53,17,7,14,7,0.07,0.24
19005,Allamakee,ia,31,46,15,7,14,7,0.34,0.69
55091,Pepin,wi,31,44,13,7,14,7,0.18,0.37
27049,Goodhue,mn,31,44,13,7,14,7,0.19,0.46
27039,Dodge,mn,30,44,14,7,14,7,0.22,0.51
27143,Sibley,mn,32,47,15,7,14,7,0.15,0.31
27015,Brown,mn,33,48,15,7,15,8,0.14,0.28
27103,Nicollet,mn,33,48,15,7,15,8,0.14,0.36
19041,Clay,ia,35,51,16,7,15,8,0.25,0.49
27147,Steele,mn,32,47,15,7,15,8,0.21,0.46
19021,Buena Vista,ia,34,50,16,7,15,8,0.23,0.41
31149,Rock,ne,40,55,15,7,15,8,0.06,0.08
19065,Fayette,ia,32,48,16,7,15,8,0.28,0.62
26115,Monroe,mi,35,53,18,7,16,9,0.14,0.39
19147,Palo Alto,ia,36,51,15,7,16,9,0.24,0.48
19081,Hancock,ia,33,49,16,7,16,9,0.23,0.49
19033,Cerro Gordo,ia,33,49,16,7,16,9,0.27,0.79
51161,Roanoke,va,47,69,22,7,18,11,0.02,0.16
51660,Harrisonburg,va,45,65,20,7,18,11,0.02,0.11
55015,Calumet,wi,24,35,11,6,9,3,0.23,0.41
27167,Wilkin,mn,26,36,10,6,10,4,0.07,0.16
46045,Edmunds,sd,30,41,11,6,10,4,0.06,0.1
46091,Marshall,sd,28,38,10,6,10,4,0.11,0.12
27149,Stevens,mn,26,37,11,6,10,4,0.11,0.22
38073,Ransom,nd,27,36,9,6,10,4,0.09,0.11
55079,Milwaukee,wi,23,35,12,6,10,4,0.22,0.54
27011,Big Stone,mn,28,39,11,6,11,5,0.12,0.26
27171,Wright,mn,27,40,13,6,11,5,0.16,0.28
55001,Adams,wi,27,39,12,6,11,5,0.26,0.42
55057,Juneau,wi,28,41,13,6,11,5,0.26,0.4
46109,Roberts,sd,27,38,11,6,11,5,0.11,0.14
55059,Kenosha,wi,23,35,12,6,11,5,0.19,0.53
46051,Grant,sd,28,39,11,6,11,5,0.07,0.13
55053,Jackson,wi,27,39,12,6,11,5,0.29,0.47
38081,Sargent,nd,27,37,10,6,11,5,0.11,0.14
55131,Washington,wi,24,36,12,6,11,5,0.15,0.4
38077,Richland,nd,27,37,10,6,11,5,0.14,0.17
42067,Juniata,pa,33,51,18,6,12,6,0.02,0.13
27053,Hennepin,mn,29,42,13,6,12,6,0.16,0.28
27109,Olmsted,mn,28,42,14,6,12,6,0.16,0.44
27151,Swift,mn,29,41,12,6,12,6,0.16,0.37
19089,Howard,ia,28,43,15,6,12,6,0.23,0.56
27063,Jackson,mn,30,44,14,6,12,6,0.14,0.27
55033,Dunn,wi,27,39,12,6,12,6,0.19,0.43
27025,Chisago,mn,28,40,12,6,12,6,0.23,0.36
55109,St. Croix,wi,28,40,12,6,12,6,0.26,0.49
26145,Saginaw,mi,30,44,14,6,12,6,0.07,0.15
27139,Scott,mn,30,43,13,6,13,7,0.17,0.33
34029,Ocean,nj,32,49,17,6,13,7,0.07,0.34
36119,Westchester,ny,30,47,17,6,13,7,0.02,0.05
42099,Perry,pa,35,53,18,6,13,7,0.02,0.12
42095,Northampton,pa,34,51,17,6,13,7,0.02,0.04
55011,Buffalo,wi,30,43,13,6,13,7,0.22,0.46
55121,Trempealeau,wi,29,41,12,6,13,7,0.28,0.5
26159,Van Buren,mi,30,46,16,6,13,7,0.24,0.53
19191,Winneshiek,ia,29,45,16,6,13,7,0.28,0.55
31041,Custer,ne,41,56,15,6,13,7,0.03,0.06
27133,Rock,mn,32,46,14,6,13,7,0.17,0.23
27019,Carver,mn,30,44,14,6,13,7,0.17,0.3
27169,Winona,mn,29,42,13,6,13,7,0.26,0.47
55049,Iowa,wi,28,42,14,6,13,7,0.26,0.57
27055,Houston,mn,28,42,14,6,13,7,0.26,0.48
55093,Pierce,wi,29,42,13,6,13,7,0.19,0.34
42109,Snyder,pa,33,50,17,6,13,7,0.08,0.23
42077,Lehigh,pa,35,52,17,6,13,7,0.04,0.14
27079,Le Sueur,mn,30,45,15,6,13,7,0.15,0.32
36005,Bronx,ny,31,48,17,6,13,7,0.01,0.06
31017,Brown,ne,40,55,15,6,13,7,0.04,0.06
34017,Hudson,nj,32,49,17,6,13,7,0.01,0.08
27037,Dakota,mn,30,43,13,6,13,7,0.19,0.38
27047,Freeborn,mn,29,44,15,6,13,7,0.13,0.41
18151,Steuben,in,30,47,17,6,13,7,0.07,0.4
36087,Rockland,ny,31,47,16,6,13,7,0.02,0.06
39115,Morgan,oh,39,60,21,6,15,9,0.04,0.14
48179,Gray,tx,66,83,17,6,18,12,0.02,0.04
38017,Cass,nd,24,33,9,5,8,3,0.07,0.14
27027,Clay,mn,23,32,9,5,8,3,0.07,0.12
27145,Stearns,mn,25,37,12,5,9,4,0.1,0.18
27121,Pope,mn,25,36,11,5,9,4,0.11,0.18
55089,Ozaukee,wi,19,30,11,5,9,4,0.12,0.42
55135,Waupaca,wi,23,34,11,5,9,4,0.17,0.31
38021,Dickey,nd,27,37,10,5,9,4,0.11,0.13
55087,Outagamie,wi,23,33,10,5,9,4,0.16,0.27
55095,Polk,wi,23,34,11,5,9,4,0.23,0.38
55139,Winnebago,wi,24,34,10,5,9,4,0.18,0.41
27051,Grant,mn,24,34,10,5,9,4,0.09,0.22
46021,Campbell,sd,29,40,11,5,9,4,0.04,0.07
34041,Warren,nj,28,43,15,5,10,5,0.02,0.03
26147,St. Clair,mi,25,39,14,5,10,5,0.15,0.21
46079,Lake,sd,28,40,12,5,10,5,0.1,0.14
27101,Murray,mn,28,41,13,5,10,5,0.12,0.21
46077,Kingsbury,sd,29,41,12,5,10,5,0.11,0.17
55039,Fond du Lac,wi,24,36,12,5,10,5,0.18,0.41
27117,Pipestone,mn,27,39,12,5,10,5,0.09,0.15
55101,Racine,wi,21,33,12,5,10,5,0.2,0.56
27059,Isanti,mn,24,36,12,5,10,5,0.22,0.31
55137,Waushara,wi,25,37,12,5,10,5,0.2,0.43
55035,Eau Claire,wi,25,36,11,5,10,5,0.19,0.32
42093,Montour,pa,28,45,17,5,10,5,0.03,0.13
36047,Kings,ny,29,46,17,5,11,6,0.01,0.04
9001,Fairfield,ct,27,43,16,5,11,6,0.01,0.08
34027,Morris,nj,28,44,16,5,11,6,0.02,0.09
36071,Orange,ny,29,45,16,5,11,6,0.01,0.05
27067,Kandiyohi,mn,28,40,12,5,11,6,0.15,0.23
46121,Todd,sd,38,51,13,5,11,6,0.04,0.04
55123,Vernon,wi,26,40,14,5,11,6,0.27,0.52
36079,Putnam,ny,27,43,16,5,11,6,0,0.04
27141,Sherburne,mn,27,39,12,5,11,6,0.16,0.2
27083,Lyon,mn,29,42,13,5,11,6,0.09,0.15
27093,Meeker,mn,28,41,13,5,11,6,0.12,0.16
27045,Fillmore,mn,26,40,14,5,11,6,0.14,0.36
26057,Gratiot,mi,28,42,14,5,11,6,0.09,0.2
26025,Calhoun,mi,29,45,16,5,11,6,0.12,0.45
36085,Richmond,ny,30,47,17,5,11,6,0.01,0.05
36027,Dutchess,ny,29,45,16,5,11,6,0.03,0.06
26111,Midland,mi,28,42,14,5,11,6,0.04,0.12
55081,Monroe,wi,26,39,13,5,11,6,0.28,0.44
26157,Tuscola,mi,27,41,14,5,11,6,0.08,0.13
36081,Queens,ny,29,45,16,5,12,7,0.01,0.06
54023,Grant,wv,32,49,17,5,12,7,0.06,0.15
26015,Barry,mi,30,45,15,5,12,7,0.12,0.33
27099,Mower,mn,27,42,15,5,12,7,0.14,0.42
31113,Logan,ne,42,56,14,5,12,7,0.01,0.01
39033,Crawford,oh,29,47,18,5,12,7,0.08,0.28
31111,Lincoln,ne,43,57,14,5,12,7,0.02,0.02
26161,Washtenaw,mi,31,48,17,5,12,7,0.11,0.26
27105,Nobles,mn,30,44,14,5,12,7,0.18,0.25
39093,Lorain,oh,29,47,18,5,12,7,0.08,0.17
54095,Tyler,wv,36,56,20,5,13,8,0.02,0.04
31009,Blaine,ne,40,54,14,5,13,8,0.02,0.06
39157,Tuscarawas,oh,33,53,20,5,13,8,0.03,0.09
26091,Lenawee,mi,31,49,18,5,13,8,0.09,0.34
39031,Coshocton,oh,33,52,19,5,13,8,0.08,0.28
31085,Hayes,ne,47,62,15,5,13,8,0.01,0.01
13241,Rabun,ga,40,62,22,5,13,8,0.01,0.06
20199,Wallace,ks,56,72,16,5,14,9,0.01,0.01
39119,Muskingum,oh,35,55,20,5,14,9,0.07,0.28
39127,Perry,oh,37,58,21,5,14,9,0.04,0.13
39121,Noble,oh,36,56,20,5,14,9,0.04,0.13
39059,Guernsey,oh,36,56,20,5,14,9,0.03,0.12
8099,Prowers,co,64,80,16,5,15,10,0.01,0.01
48189,Hale,tx,69,89,20,5,15,10,0.01,0.03
48229,Hudspeth,tx,75,98,23,5,16,11,0.04,0.33
48065,Carson,tx,67,85,18,5,16,11,0.02,0.02
27107,Norman,mn,22,31,9,4,7,3,0.06,0.11
38015,Burleigh,nd,25,34,9,4,7,3,0.03,0.06
55115,Shawano,wi,20,30,10,4,7,3,0.15,0.26
30085,Roosevelt,mt,28,38,10,4,8,4,0,0.03
38085,Sioux,nd,29,40,11,4,8,4,0.04,0.06
30083,Richland,mt,28,39,11,4,8,4,0,0.03
27097,Morrison,mn,23,33,10,4,8,4,0.09,0.18
38097,Traill,nd,23,32,9,4,8,4,0.06,0.11
38045,LaMoure,nd,24,33,9,4,8,4,0.08,0.1
46039,Deuel,sd,23,34,11,4,8,4,0.06,0.13
27153,Todd,mn,22,32,10,4,8,4,0.11,0.21
46089,McPherson,sd,26,37,11,4,8,4,0.07,0.09
26017,Bay,mi,23,35,12,4,8,4,0.04,0.12
27081,Lincoln,mn,24,36,12,4,8,4,0.08,0.13
25023,Plymouth,ma,20,32,12,4,8,4,0.05,0.08
30017,Custer,mt,34,47,13,4,8,4,0,0
46031,Corson,sd,30,41,11,4,8,4,0.04,0.04
46029,Codington,sd,23,33,10,4,8,4,0.05,0.08
55017,Chippewa,wi,22,33,11,4,8,4,0.18,0.31
55078,Menominee,wi,21,31,10,4,8,4,0.13,0.22
55117,Sheboygan,wi,19,30,11,4,8,4,0.18,0.41
26049,Genesee,mi,24,37,13,4,8,4,0.08,0.14
41033,Josephine,or,34,47,13,4,9,5,0,0.02
25017,Middlesex,ma,23,37,14,4,9,5,0.01,0.02
26099,Macomb,mi,25,40,15,4,9,5,0.09,0.14
26163,Wayne,mi,27,43,16,4,9,5,0.07,0.14
34025,Monmouth,nj,27,43,16,4,9,5,0.03,0.13
42097,Northumberland,pa,26,41,15,4,9,5,0.06,0.19
25005,Bristol,ma,21,34,13,4,9,5,0.05,0.07
54031,Hardy,wv,29,47,18,4,9,5,0.07,0.19
44007,Providence,ri,21,35,14,4,9,5,0.03,0.06
6109,Tuolumne,ca,39,56,17,4,9,5,0.01,0.03
25021,Norfolk,ma,22,35,13,4,9,5,0.03,0.02
44001,Bristol,ri,20,34,14,4,9,5,0.03,0.03
39099,Mahoning,oh,27,44,17,4,9,5,0.03,0.07
26065,Ingham,mi,25,40,15,4,9,5,0.07,0.19
26155,Shiawassee,mi,26,40,14,4,9,5,0.08,0.18
26125,Oakland,mi,26,41,15,4,9,5,0.08,0.12
26045,Eaton,mi,26,41,15,4,9,5,0.08,0.29
26117,Montcalm,mi,26,39,13,4,9,5,0.11,0.22
42037,Columbia,pa,26,41,15,4,9,5,0.03,0.07
26073,Isabella,mi,24,36,12,4,9,5,0.05,0.13
26087,Lapeer,mi,25,39,14,4,9,5,0.09,0.21
46129,Walworth,sd,29,40,11,4,9,5,0.03,0.06
46057,Hamlin,sd,26,36,10,4,9,5,0.04,0.07
46037,Day,sd,25,35,10,4,9,5,0.08,0.1
26151,Sanilac,mi,22,35,13,4,9,5,0.1,0.17
46025,Clark,sd,26,36,10,4,9,5,0.05,0.11
42087,Mifflin,pa,27,44,17,4,9,5,0.02,0.07
36001,Albany,ny,25,40,15,4,9,5,0.01,0.03
46101,Moody,sd,26,38,12,4,9,5,0.08,0.13
26081,Kent,mi,25,39,14,4,9,5,0.09,0.22
9009,New Haven,ct,24,40,16,4,10,6,0,0.07
25013,Hampden,ma,25,40,15,4,10,6,0.01,0.02
16087,Washington,id,39,51,12,4,10,6,0,0.01
39123,Ottawa,oh,24,41,17,4,10,6,0.06,0.19
26037,Clinton,mi,27,41,14,4,10,6,0.11,0.21
39153,Summit,oh,25,42,17,4,10,6,0.04,0.06
26075,Jackson,mi,26,42,16,4,10,6,0.08,0.35
39151,Stark,oh,26,44,18,4,10,6,0.03,0.07
39013,Belmont,oh,30,48,18,4,10,6,0.02,0.03
9003,Hartford,ct,25,40,15,4,10,6,0.01,0.07
39169,Wayne,oh,27,44,17,4,10,6,0.08,0.19
26067,Ionia,mi,27,41,14,4,10,6,0.12,0.25
26005,Allegan,mi,27,42,15,4,10,6,0.09,0.3
54029,Hancock,wv,29,48,19,4,10,6,0.02,0.07
42057,Fulton,pa,31,49,18,4,10,6,0.03,0.08
36111,Ulster,ny,27,42,15,4,10,6,0.03,0.06
42059,Greene,pa,32,51,19,4,11,7,0.02,0.07
54027,Hampshire,wv,33,52,19,4,11,7,0.02,0.11
42003,Allegheny,pa,30,49,19,4,11,7,0.03,0.09
31171,Thomas,ne,39,53,14,4,11,7,0.01,0.01
39103,Medina,oh,27,45,18,4,11,7,0.09,0.17
39067,Harrison,oh,31,50,19,4,11,7,0.02,0.08
39077,Huron,oh,27,45,18,4,11,7,0.08,0.22
39019,Carroll,oh,29,48,19,4,11,7,0.02,0.08
39083,Knox,oh,29,48,19,4,11,7,0.08,0.26
39117,Morrow,oh,28,46,18,4,11,7,0.07,0.33
39155,Trumbull,oh,29,47,18,4,11,7,0.03,0.06
39081,Jefferson,oh,31,50,19,4,11,7,0.02,0.06
39005,Ashland,oh,27,45,18,4,11,7,0.08,0.18
26059,Hillsdale,mi,27,44,17,4,11,7,0.08,0.4
31101,Keith,ne,44,58,14,4,11,7,0.01,0.01
39075,Holmes,oh,28,47,19,4,11,7,0.06,0.12
54103,Wetzel,wv,35,55,20,4,12,8,0.01,0.02
48437,Swisher,tx,64,84,20,4,12,8,0,0.02
39111,Monroe,oh,32,52,20,4,12,8,0.02,0.06
48501,Yoakum,tx,75,96,21,4,12,8,0,0.01
21131,Leslie,ky,40,61,21,4,13,9,0.01,0.06
54017,Doddridge,wv,36,56,20,4,13,9,0.02,0.06
54033,Harrison,wv,35,56,21,4,13,9,0.03,0.04
54049,Marion,wv,35,56,21,4,13,9,0.03,0.02
20023,Cheyenne,ks,52,67,15,4,13,9,0,0.01
48341,Moore,tx,65,82,17,4,14,10,0,0.01
51169,Scott,va,44,67,23,4,14,10,0.01,0.03
47179,Washington,tn,45,69,24,4,14,10,0,0.03
27089,Marshall,mn,18,25,7,3,5,2,0.03,0.04
38067,Pembina,nd,16,24,8,3,5,2,0.02,0.03
38055,McLean,nd,20,28,8,3,5,2,0.03,0.04
30033,Garfield,mt,28,40,12,3,5,2,0,0.01
27069,Kittson,mn,17,24,7,3,5,2,0.02,0.06
38051,McIntosh,nd,21,29,8,3,5,2,0.04,0.08
38027,Eddy,nd,19,26,7,3,5,2,0.01,0.04
27125,Red Lake,mn,16,24,8,3,5,2,0.03,0.04
38007,Billings,nd,24,34,10,3,5,2,0,0.01
38105,Williams,nd,22,30,8,3,5,2,0.01,0.01
38057,Mercer,nd,23,32,9,3,5,2,0.02,0.03
38069,Pierce,nd,19,26,7,3,5,2,0.02,0.05
38047,Logan,nd,20,29,9,3,5,2,0.04,0.07
38063,Nelson,nd,17,25,8,3,5,2,0.02,0.04
30091,Sheridan,mt,22,31,9,3,5,2,0,0.01
27113,Pennington,mn,16,24,8,3,5,2,0.03,0.06
38037,Grant,nd,25,35,10,3,6,3,0.03,0.03
38099,Walsh,nd,19,27,8,3,6,3,0.03,0.03
30055,McCone,mt,27,38,11,3,6,3,0,0.03
38053,McKenzie,nd,24,34,10,3,6,3,0.01,0.01
38059,Morton,nd,25,34,9,3,6,3,0.04,0.06
38103,Wells,nd,21,29,8,3,6,3,0.02,0.04
38065,Oliver,nd,23,32,9,3,6,3,0.03,0.04
42107,Schuylkill,pa,20,34,14,3,6,3,0.04,0.12
38039,Griggs,nd,19,27,8,3,6,3,0.03,0.04
38043,Kidder,nd,21,29,8,3,6,3,0.03,0.06
38083,Sheridan,nd,21,29,8,3,6,3,0.02,0.04
38031,Foster,nd,20,27,7,3,6,3,0.04,0.04
38049,McHenry,nd,20,27,7,3,6,3,0.02,0.06
36055,Monroe,ny,20,33,13,3,6,3,0.01,0.02
6013,Contra Costa,ca,27,40,13,3,7,4,0.03,0.01
33015,Rockingham,nh,20,32,12,3,7,4,0.02,0.01
9007,Middlesex,ct,20,35,15,3,7,4,0,0.05
36073,Orleans,ny,20,34,14,3,7,4,0.02,0.07
46011,Brookings,sd,23,34,11,3,7,4,0.06,0.1
34037,Sussex,nj,22,36,14,3,7,4,0,0.04
42081,Lycoming,pa,23,38,15,3,7,4,0.03,0.09
41029,Jackson,or,31,44,13,3,7,4,0,0
6105,Trinity,ca,32,45,13,3,7,4,0,0
42085,Mercer,pa,23,40,17,3,7,4,0.01,0.06
46105,Perkins,sd,31,42,11,3,7,4,0.02,0.02
6037,Los Angeles,ca,36,52,16,3,8,5,0.01,0.06
36091,Saratoga,ny,23,37,14,3,8,5,0.01,0.03
39043,Erie,oh,21,37,16,3,8,5,0.04,0.12
25025,Suffolk,ma,21,33,12,3,8,5,0.01,0.02
33017,Strafford,nh,20,33,13,3,8,5,0.02,0.04
53077,Yakima,wa,27,39,12,3,8,5,0.01,0.01
25009,Essex,ma,19,31,12,3,8,5,0.02,0.07
41049,Morrow,or,26,37,11,3,8,5,0,0.01
6111,Ventura,ca,28,41,13,3,8,5,0.01,0.06
8115,Sedgwick,co,44,59,15,3,8,5,0.01,0.01
36099,Seneca,ny,21,36,15,3,8,5,0.01,0.04
44003,Kent,ri,20,33,13,3,8,5,0.02,0.04
26093,Livingston,mi,24,39,15,3,8,5,0.06,0.17
36021,Columbia,ny,22,36,14,3,8,5,0.03,0.06
36093,Schenectady,ny,21,35,14,3,8,5,0.01,0.03
25015,Hampshire,ma,22,35,13,3,8,5,0.01,0
26085,Lake,mi,21,34,13,3,8,5,0.06,0.17
26139,Ottawa,mi,23,37,14,3,8,5,0.04,0.22
42005,Armstrong,pa,26,44,18,3,9,6,0.02,0.04
20181,Sherman,ks,47,63,16,3,9,6,0,0.01
42061,Huntingdon,pa,27,44,17,3,9,6,0.02,0.07
48079,Cochran,tx,67,87,20,3,9,6,0,0
34009,Cape May,nj,30,48,18,3,9,6,0.04,0.24
21133,Letcher,ky,32,52,20,3,9,6,0.02,0.04
42073,Lawrence,pa,27,44,17,3,9,6,0.01,0.05
48279,Lamb,tx,63,84,21,3,9,6,0,0.03
48017,Bailey,tx,65,85,20,3,9,6,0,0
39133,Portage,oh,25,42,17,3,9,6,0.03,0.06
54069,Ohio,wv,28,46,18,3,9,6,0.01,0.03
37115,Madison,nc,31,51,20,3,10,7,0,0.03
54061,Monongalia,wv,28,47,19,3,10,7,0.01,0.03
42007,Beaver,pa,28,47,19,3,10,7,0.02,0.06
54051,Marshall,wv,30,49,19,3,10,7,0.02,0.03
39029,Columbiana,oh,27,45,18,3,10,7,0.02,0.07
54091,Taylor,wv,29,50,21,3,10,7,0.03,0.02
42125,Washington,pa,29,47,18,3,10,7,0.03,0.04
37043,Clay,nc,38,61,23,3,11,8,0.01,0.04
48381,Randall,tx,62,82,20,3,11,8,0.01,0.02
8089,Otero,co,64,80,16,3,11,8,0,0.01
35051,Sierra,nm,63,88,25,3,12,9,0.04,0.36
48421,Sherman,tx,61,78,17,3,12,9,0,0.01
27077,Lake of the Woods,mn,12,18,6,2,3,1,0.02,0.08
55003,Ashland,wi,11,19,8,2,3,1,0.06,0.08
38071,Ramsey,nd,14,20,6,2,3,1,0.02,0.03
55067,Langlade,wi,12,19,7,2,3,1,0.13,0.2
27071,Koochiching,mn,11,18,7,2,3,1,0.03,0.07
38009,Bottineau,nd,14,21,7,2,3,1,0.03,0.03
27057,Hubbard,mn,14,21,7,2,3,1,0.03,0.05
55061,Kewaunee,wi,10,17,7,2,3,1,0.07,0.13
38075,Renville,nd,16,22,6,2,3,1,0.01,0.03
41021,Gilliam,or,19,30,11,2,4,2,0,0.01
26135,Oscoda,mi,15,24,9,2,4,2,0,0.01
6079,San Luis Obispo,ca,19,26,7,2,4,2,0,0.01
42103,Pike,pa,15,26,11,2,4,2,0,0.01
55069,Lincoln,wi,13,21,8,2,4,2,0.05,0.08
55075,Marinette,wi,14,22,8,2,4,2,0.03,0.08
26007,Alpena,mi,12,19,7,2,4,2,0.04,0.07
27021,Cass,mn,15,22,7,2,4,2,0.06,0.16
27087,Mahnomen,mn,15,23,8,2,4,2,0.06,0.06
26003,Alger,mi,11,18,7,2,4,2,0.11,0.19
30003,Big Horn,mt,28,40,12,2,4,2,0,0
55007,Bayfield,wi,14,22,8,2,4,2,0.07,0.1
26089,Leelanau,mi,12,21,9,2,4,2,0.03,0.05
26141,Presque Isle,mi,12,20,8,2,4,2,0.01,0.02
38101,Ward,nd,17,24,7,2,4,2,0.02,0.06
36107,Tioga,ny,15,28,13,2,4,2,0,0.01
26119,Montmorency,mi,15,24,9,2,4,2,0,0.02
36051,Livingston,ny,15,28,13,2,4,2,0.01,0.01
27135,Roseau,mn,14,20,6,2,4,2,0.02,0.03
26001,Alcona,mi,14,23,9,2,4,2,0.01,0.02
26009,Antrim,mi,14,23,9,2,4,2,0.03,0.03
27001,Aitkin,mn,14,22,8,2,4,2,0.05,0.13
26043,Dickinson,mi,13,21,8,2,4,2,0.03,0.08
55031,Douglas,wi,13,21,8,2,4,2,0.05,0.1
27017,Carlton,mn,14,22,8,2,4,2,0.02,0.06
42015,Bradford,pa,15,28,13,2,4,2,0.01,0.01
26069,Iosco,mi,16,26,10,2,4,2,0.01,0.01
26029,Charlevoix,mi,12,21,9,2,4,2,0.03,0.03
26129,Ogemaw,mi,16,26,10,2,4,2,0.01,0.02
36089,St. Lawrence,ny,13,23,10,2,4,2,0.02,0.03
26109,Menominee,mi,12,20,8,2,4,2,0.03,0.08
53017,Douglas,wa,20,31,11,2,4,2,0,0
6057,Nevada,ca,26,40,14,2,5,3,0.01,0.01
30087,Rosebud,mt,30,43,13,2,5,3,0,0
36065,Oneida,ny,16,29,13,2,5,3,0.01,0.01
46093,Meade,sd,27,39,12,2,5,3,0.02,0.02
16073,Owyhee,id,26,39,13,2,5,3,0,0.02
30069,Petroleum,mt,27,39,12,2,5,3,0,0.01
6073,San Diego,ca,22,36,14,2,5,3,0.02,0.34
55113,Sawyer,wi,15,24,9,2,5,3,0.06,0.12
36123,Yates,ny,16,28,12,2,5,3,0,0.02
51017,Bath,va,19,35,16,2,5,3,0.03,0.16
38005,Benson,nd,17,24,7,2,5,3,0.02,0.04
42089,Monroe,pa,16,28,12,2,5,3,0,0.03
26055,Grand Traverse,mi,15,25,10,2,5,3,0.02,0.03
36075,Oswego,ny,15,28,13,2,5,3,0.02,0.02
42131,Wyoming,pa,17,30,13,2,5,3,0,0
36113,Warren,ny,15,27,12,2,5,3,0.01,0.02
42013,Blair,pa,18,33,15,2,5,3,0.01,0.04
31123,Morrill,ne,38,53,15,2,5,3,0,0
26133,Osceola,mi,16,26,10,2,5,3,0.02,0.07
26019,Benzie,mi,14,23,9,2,5,3,0.04,0.06
26035,Clare,mi,18,28,10,2,5,3,0.02,0.08
26011,Arenac,mi,15,25,10,2,5,3,0.01,0.04
26121,Muskegon,mi,16,27,11,2,5,3,0.03,0.19
26101,Manistee,mi,15,25,10,2,5,3,0.04,0.1
27005,Becker,mn,16,24,8,2,5,3,0.07,0.07
46047,Fall River,sd,35,49,14,2,5,3,0.01,0.02
38001,Adams,nd,25,36,11,2,5,3,0.02,0.02
30103,Treasure,mt,31,44,13,2,5,3,0,0
30109,Wibaux,mt,23,34,11,2,5,3,0,0
27035,Crow Wing,mn,16,25,9,2,5,3,0.06,0.14
42025,Carbon,pa,18,30,12,2,5,3,0.01,0.02
38041,Hettinger,nd,24,34,10,2,5,3,0.02,0.01
36037,Genesee,ny,18,31,13,2,5,3,0,0.01
38025,Dunn,nd,22,31,9,2,5,3,0,0.01
46019,Butte,sd,31,44,13,2,5,3,0.01,0.01
31069,Garden,ne,35,50,15,2,5,3,0.01,0.01
36063,Niagara,ny,17,29,12,2,5,3,0.03,0.08
25027,Worcester,ma,17,29,12,2,5,3,0.01,0.01
36115,Washington,ny,18,31,13,2,6,4,0.01,0.03
42035,Clinton,pa,19,33,14,2,6,4,0.02,0.02
53025,Grant,wa,26,39,13,2,6,4,0,0
54001,Barbour,wv,21,38,17,2,6,4,0.02,0.03
54025,Greenbrier,wv,22,40,18,2,6,4,0.03,0.08
9005,Litchfield,ct,17,30,13,2,6,4,0.01,0.04
25011,Franklin,ma,18,30,12,2,6,4,0,0
39007,Ashtabula,oh,19,34,15,2,6,4,0.02,0.04
42079,Luzerne,pa,18,31,13,2,6,4,0.03,0.05
42063,Indiana,pa,19,35,16,2,6,4,0.01,0.04
16001,Ada,id,36,51,15,2,6,4,0,0.01
42009,Bedford,pa,22,38,16,2,6,4,0.01,0.07
36011,Cayuga,ny,18,31,13,2,6,4,0,0.03
53001,Adams,wa,25,37,12,2,6,4,0,0
31005,Arthur,ne,34,49,15,2,6,4,0.01,0
39085,Lake,oh,20,36,16,2,6,4,0,0.03
33011,Hillsborough,nh,19,32,13,2,6,4,0.01,0.01
8095,Phillips,co,38,54,16,2,6,4,0,0.01
26127,Oceana,mi,17,28,11,2,6,4,0.02,0.12
16039,Elmore,id,36,47,11,2,7,5,0,0.01
39035,Cuyahoga,oh,21,37,16,2,7,5,0.04,0.05
54047,McDowell,wv,25,45,20,2,7,5,0.01,0.05
37075,Graham,nc,27,48,21,2,7,5,0.01,0.03
54019,Fayette,wv,23,42,19,2,7,5,0.01,0.03
54109,Wyoming,wv,26,46,20,2,7,5,0.01,0.03
49019,Grand,ut,55,71,16,2,7,5,0,0.02
51121,Montgomery,va,26,45,19,2,7,5,0.01,0.05
39055,Geauga,oh,20,35,15,2,7,5,0.02,0.03
51191,Washington,va,30,51,21,2,7,5,0.01,0.02
8125,Yuma,co,45,60,15,2,7,5,0,0.02
16045,Gem,id,36,50,14,2,7,5,0,0
48069,Castro,tx,55,77,22,2,7,5,0,0.01
42019,Butler,pa,24,41,17,2,7,5,0.02,0.04
54097,Upshur,wv,22,40,18,2,7,5,0.02,0.03
51750,Radford,va,27,47,20,2,7,5,0.01,0.01
35041,Roosevelt,nm,63,84,21,2,7,5,0,0.01
31049,Deuel,ne,40,55,15,2,7,5,0.01,0.01
36083,Rensselaer,ny,19,33,14,2,7,5,0.01,0.03
16047,Gooding,id,42,56,14,2,7,5,0,0.01
37175,Transylvania,nc,29,50,21,2,8,6,0.02,0.05
47019,Carter,tn,28,47,19,2,8,6,0,0.02
37021,Buncombe,nc,31,52,21,2,8,6,0,0.02
51027,Buchanan,va,29,49,20,2,8,6,0.01,0.07
35035,Otero,nm,39,55,16,2,8,6,0.09,0.57
21095,Harlan,ky,29,50,21,2,8,6,0.01,0.02
48117,Deaf Smith,tx,57,78,21,2,8,6,0.01,0.02
40025,Cimarron,ok,57,75,18,2,9,7,0.01,0.01
13281,Towns,ga,32,54,22,2,9,7,0,0.03
48375,Potter,tx,58,78,20,2,10,8,0.01,0.01
55051,Iron,wi,9,15,6,1,2,1,0.02,0.05
16061,Lewis,id,13,21,8,1,3,2,0,0.01
36029,Erie,ny,12,24,12,1,3,2,0.02,0.03
36045,Jefferson,ny,10,20,10,1,3,2,0.02,0.03
36077,Otsego,ny,10,20,10,1,3,2,0.01,0.01
26103,Marquette,mi,8,13,5,1,3,2,0.02,0.06
27061,Itasca,mn,12,18,6,1,3,2,0.02,0.05
36031,Essex,ny,11,21,10,1,3,2,0.02,0.01
55037,Florence,wi,11,18,7,1,3,2,0.02,0.02
6093,Siskiyou,ca,21,33,12,1,3,2,0,0
44009,Washington,ri,11,22,11,1,3,2,0.01,0.03
26071,Iron,mi,10,17,7,1,3,2,0.02,0.03
36017,Chenango,ny,12,23,11,1,3,2,0,0.01
23011,Kennebec,me,11,21,10,1,3,2,0,0
33003,Carroll,nh,12,23,11,1,3,2,0.02,0.01
26079,Kalkaska,mi,13,21,8,1,3,2,0.01,0.01
26039,Crawford,mi,14,22,8,1,3,2,0,0.01
50007,Chittenden,vt,12,23,11,1,3,2,0,0.01
44005,Newport,ri,11,22,11,1,3,2,0.02,0.04
36023,Cortland,ny,12,22,10,1,3,2,0,0.01
55099,Price,wi,11,18,7,1,3,2,0.03,0.04
36101,Steuben,ny,12,24,12,1,3,2,0.01,0.02
41069,Wheeler,or,16,25,9,1,3,2,0,0
16003,Adams,id,17,28,11,1,3,2,0,0.01
23001,Androscoggin,me,12,23,11,1,3,2,0,0
42039,Crawford,pa,14,26,12,1,3,2,0.01,0.01
36043,Herkimer,ny,13,24,11,1,4,3,0.02,0.02
36053,Madison,ny,13,25,12,1,4,3,0.01,0.02
53007,Chelan,wa,18,28,10,1,4,3,0,0
23031,York,me,11,21,10,1,4,3,0.02,0.04
36105,Sullivan,ny,13,24,11,1,4,3,0.01,0.01
54071,Pendleton,wv,16,30,14,1,4,3,0.01,0.04
42027,Centre,pa,16,29,13,1,4,3,0.02,0.06
42031,Clarion,pa,16,31,15,1,4,3,0.01,0.02
26165,Wexford,mi,12,21,9,1,4,3,0.03,0.06
36019,Clinton,ny,13,24,11,1,4,3,0,0.02
36097,Schuyler,ny,15,26,11,1,4,3,0,0.02
33013,Merrimack,nh,15,27,12,1,4,3,0.01,0.01
42069,Lackawanna,pa,13,24,11,1,4,3,0.01,0
48243,Jeff Davis,tx,46,66,20,1,4,3,0.01,0.03
36109,Tompkins,ny,14,26,12,1,4,3,0,0.02
31045,Dawes,ne,32,46,14,1,4,3,0,0.02
36007,Broome,ny,13,24,11,1,4,3,0,0.01
50001,Addison,vt,13,23,10,1,4,3,0.02,0.01
26113,Missaukee,mi,13,22,9,1,4,3,0.01,0.04
50013,Grand Isle,vt,14,26,12,1,4,3,0,0.01
36035,Fulton,ny,14,26,12,1,4,3,0.01,0.02
31075,Grant,ne,30,44,14,1,4,3,0,0.02
51167,Russell,va,20,37,17,1,4,3,0.01,0.02
36103,Suffolk,ny,16,31,15,1,5,4,0.01,0.1
51155,Pulaski,va,23,42,19,1,5,4,0.01,0.01
9013,Tolland,ct,16,29,13,1,5,4,0.01,0.01
54089,Summers,wv,22,40,18,1,5,4,0.01,0.01
51035,Carroll,va,22,39,17,1,5,4,0,0.02
51071,Giles,va,21,39,18,1,5,4,0.01,0.01
35011,De Baca,nm,61,83,22,1,6,5,0,0.01
54063,Monroe,wv,22,40,18,1,6,5,0.01,0.01
48369,Parmer,tx,55,76,21,1,6,5,0.01,0.01
35009,Curry,nm,57,78,21,1,6,5,0.01,0.01
55133,Waukesha,wi,29,42,13,8,13,5,0.22,0.56
27073,Lac qui Parle,mn,33,45,12,8,14,6,0.18,0.38
55023,Crawford,wi,32,47,15,8,15,7,0.42,0.81
27155,Traverse,mn,29,40,11,7,12,5,0.11,0.18
27173,Yellow Medicine,mn,32,45,13,7,13,6,0.16,0.27
46099,Minnehaha,sd,33,47,14,7,13,6,0.13,0.18
27085,McLeod,mn,31,44,13,7,13,6,0.15,0.29
55063,La Crosse,wi,31,45,14,7,14,7,0.28,0.5
19131,Mitchell,ia,32,47,15,7,15,8,0.25,0.69
42011,Berks,pa,35,53,18,6,13,7,0.04,0.16
38035,Grand Forks,nd,20,28,8,4,6,2,0.03,0.07
38003,Barnes,nd,22,31,9,4,7,3,0.07,0.08
27095,Mille Lacs,mn,20,30,10,4,7,3,0.12,0.2
55097,Portage,wi,20,30,10,4,7,3,0.13,0.28
38029,Emmons,nd,26,36,10,4,7,3,0.04,0.09
27065,Kanabec,mn,21,31,10,4,7,3,0.14,0.18
55013,Burnett,wi,20,30,10,4,7,3,0.16,0.26
55009,Brown,wi,19,28,9,4,7,3,0.16,0.26
38091,Steele,nd,20,29,9,4,7,3,0.03,0.07
38093,Stutsman,nd,22,31,9,4,7,3,0.06,0.07
26063,Huron,mi,19,30,11,4,8,4,0.07,0.15
55005,Barron,wi,21,32,11,4,8,4,0.14,0.27
55141,Wood,wi,22,32,10,4,8,4,0.16,0.21
27009,Benton,mn,23,35,12,4,8,4,0.12,0.19
27119,Polk,mn,18,26,8,3,5,2,0.03,0.07
55073,Marathon,wi,16,25,9,3,5,2,0.14,0.21
55071,Manitowoc,wi,13,21,8,3,5,2,0.23,0.41
55083,Oconto,wi,17,25,8,3,5,2,0.12,0.2
6045,Mendocino,ca,23,32,9,3,6,3,0.01,0.02
27159,Wadena,mn,17,26,9,3,6,3,0.07,0.16
26105,Mason,mi,18,29,11,3,6,3,0.03,0.13
32017,Lincoln,nv,38,54,16,3,6,3,0.01,0.03
36015,Chemung,ny,19,33,14,3,6,3,0.01,0.02
27111,Otter Tail,mn,20,29,9,3,6,3,0.08,0.15
27115,Pine,mn,18,28,10,3,6,3,0.17,0.27
55107,Rusk,wi,17,26,9,3,6,3,0.15,0.16
36067,Onondaga,ny,19,32,13,3,7,4,0.01,0.03
26051,Gladwin,mi,22,34,12,3,7,4,0.02,0.07
27041,Douglas,mn,20,29,9,3,7,4,0.08,0.17
36117,Wayne,ny,21,34,13,3,7,4,0.01,0.04
26123,Newaygo,mi,21,34,13,3,7,4,0.04,0.16
55129,Washburn,wi,19,29,10,3,7,4,0.08,0.14
30079,Prairie,mt,29,41,12,3,7,4,0,0
36039,Greene,ny,18,29,11,3,7,4,0.03,0.06
55019,Clark,wi,19,29,10,3,7,4,0.21,0.29
26107,Mecosta,mi,19,32,13,3,7,4,0.03,0.1
42051,Fayette,pa,24,41,17,3,8,5,0.02,0.07
38061,Mountrail,nd,17,24,7,2,3,1,0.01,0.02
38023,Divide,nd,16,24,8,2,3,1,0.01,0.02
30071,Phillips,mt,22,33,11,2,4,2,0,0.01
30105,Valley,mt,21,31,10,2,4,2,0,0.02
38033,Golden Valley,nd,23,33,10,2,4,2,0,0
30075,Powder River,mt,27,41,14,2,4,2,0,0
55119,Taylor,wi,14,23,9,2,4,2,0.15,0.2
46063,Harding,sd,25,37,12,2,4,2,0,0.01
38089,Stark,nd,21,31,10,2,4,2,0.01,0.01
38087,Slope,nd,22,33,11,2,4,2,0,0
46103,Pennington,sd,23,34,11,2,4,2,0.02,0.02
38011,Bowman,nd,22,33,11,2,4,2,0,0.01
30011,Carter,mt,23,36,13,2,4,2,0,0.01
30025,Fallon,mt,24,36,12,2,5,3,0,0
36069,Ontario,ny,18,31,13,2,6,4,0.01,0.04
35053,Socorro,nm,65,87,22,2,8,6,0,0.08
6023,Humboldt,ca,5,8,3,1,1,0,0,0
6081,San Mateo,ca,5,9,4,1,1,0,0.02,0.01
27075,Lake,mn,6,11,5,1,1,0,0.03,0.04
6001,Alameda,ca,8,14,6,1,2,1,0.01,0.01
8077,Mesa,co,41,57,16,1,2,1,0,0
16015,Boise,id,17,29,12,1,2,1,0,0
30015,Chouteau,mt,18,28,10,1,2,1,0,0.01
53065,Stevens,wa,13,22,9,1,2,1,0,0
36013,Chautauqua,ny,10,20,10,1,2,1,0.01,0.04
49003,Box Elder,ut,24,38,14,1,2,1,0.01,0.02
49011,Davis,ut,24,38,14,1,2,1,0.01,0.02
41039,Lane,or,10,19,9,1,2,1,0.01,0.01
41043,Linn,or,10,19,9,1,2,1,0,0.01
26053,Gogebic,mi,8,13,5,1,2,1,0.01,0.03
16083,Twin Falls,id,22,37,15,1,2,1,0,0.01
49049,Utah,ut,29,46,17,1,2,1,0.01,0.01
53043,Lincoln,wa,16,26,10,1,2,1,0,0
49025,Kane,ut,19,28,9,1,2,1,0,0.01
6059,Orange,ca,15,30,15,1,2,1,0,0.01
49045,Tooele,ut,24,39,15,1,2,1,0.01,0.02
50027,Windsor,vt,10,19,9,1,2,1,0.01,0.01
30005,Blaine,mt,16,26,10,1,2,1,0,0.01
30081,Ravalli,mt,12,22,10,1,2,1,0,0.01
41047,Marion,or,10,18,8,1,2,1,0,0
27137,St. Louis,mn,9,14,5,1,2,1,0.04,0.06
30089,Sanders,mt,13,23,10,1,2,1,0,0
41003,Benton,or,9,18,9,1,2,1,0,0.01
42023,Cameron,pa,11,22,11,1,2,1,0,0
23027,Waldo,me,8,16,8,1,2,1,0,0.01
25003,Berkshire,ma,10,19,9,1,2,1,0.01,0
55085,Oneida,wi,10,16,6,1,2,1,0.02,0.04
50025,Windham,vt,9,18,9,1,2,1,0.01,0
41027,Hood River,or,11,19,8,1,2,1,0.01,0.01
56045,Weston,wy,21,34,13,1,2,1,0.01,0
23019,Penobscot,me,8,16,8,1,2,1,0.01,0
26061,Houghton,mi,8,13,5,1,2,1,0.02,0.04
42117,Tioga,pa,10,20,10,1,2,1,0.01,0.01
56015,Goshen,wy,30,46,16,1,2,1,0,0
42115,Susquehanna,pa,10,19,9,1,2,1,0,0
26095,Luce,mi,9,15,6,1,2,1,0.03,0.03
36121,Wyoming,ny,9,19,10,1,2,1,0.01,0
36033,Franklin,ny,8,16,8,1,2,1,0,0.01
35021,Harding,nm,30,48,18,1,2,1,0,0.01
53041,Lewis,wa,6,12,6,1,2,1,0,0.01
36095,Schoharie,ny,8,17,9,1,2,1,0.01,0.01
41001,Baker,or,15,26,11,1,2,1,0,0
49055,Wayne,ut,9,13,4,1,2,1,0,0.02
4017,Navajo,az,19,32,13,1,2,1,0,0.01
42053,Forest,pa,10,21,11,1,2,1,0,0
50011,Franklin,vt,9,18,9,1,2,1,0,0.01
53063,Spokane,wa,15,25,10,1,2,1,0,0
42113,Sullivan,pa,8,17,9,1,2,1,0,0
41009,Columbia,or,9,16,7,1,2,1,0,0.01
38019,Cavalier,nd,10,16,6,1,2,1,0.02,0.02
46033,Custer,sd,16,26,10,1,2,1,0.01,0.01
38013,Burke,nd,14,20,6,1,2,1,0.01,0.03
53023,Garfield,wa,14,24,10,1,2,1,0,0
41053,Polk,or,11,20,9,1,2,1,0,0
30041,Hill,mt,17,26,9,1,2,1,0,0
38079,Rolette,nd,11,16,5,1,2,1,0.01,0.02
26047,Emmet,mi,8,15,7,1,2,1,0,0.03
55125,Vilas,wi,10,16,6,1,2,1,0.02,0.04
55041,Forest,wi,9,14,5,1,2,1,0.01,0.02
50021,Rutland,vt,9,18,9,1,2,1,0.01,0.02
35043,Sandoval,nm,33,52,19,1,2,1,0,0.01
49015,Emery,ut,21,36,15,1,2,1,0,0.02
55029,Door,wi,7,13,6,1,2,1,0.02,0.04
16049,Idaho,id,10,18,8,1,2,1,0.01,0.01
33009,Grafton,nh,8,17,9,1,2,1,0.01,0.01
23017,Oxford,me,9,18,9,1,2,1,0.02,0.01
6085,Santa Clara,ca,18,29,11,1,3,2,0.02,0.02
16063,Lincoln,id,29,43,14,1,3,2,0,0
41005,Clackamas,or,11,20,9,1,3,2,0,0.01
41051,Multnomah,or,10,19,9,1,3,2,0,0.01
49035,Salt Lake,ut,34,50,16,1,3,2,0.01,0.02
26041,Delta,mi,8,14,6,1,3,2,0.03,0.08
32015,Lander,nv,29,43,14,1,3,2,0,0
6097,Sonoma,ca,14,25,11,1,3,2,0.01,0.01
53047,Okanogan,wa,15,23,8,1,3,2,0,0
41019,Douglas,or,15,26,11,1,3,2,0,0.01
42033,Clearfield,pa,13,25,12,1,3,2,0.02,0.01
51063,Floyd,va,16,32,16,1,3,2,0.01,0.08
16035,Clearwater,id,15,24,9,1,3,2,0,0.01
26137,Otsego,mi,12,21,9,1,3,2,0.01,0.01
53011,Clark,wa,10,18,8,1,3,2,0,0.01
35019,Guadalupe,nm,41,63,22,1,3,2,0,0.01
41031,Jefferson,or,18,29,11,1,3,2,0.02,0.01
31033,Cheyenne,ne,29,43,14,1,3,2,0.01,0
38095,Towner,nd,12,18,6,1,3,2,0.01,0.01
42121,Venango,pa,14,28,14,1,3,2,0.01,0.01
49027,Millard,ut,37,54,17,1,3,2,0,0
30019,Daniels,mt,18,27,9,1,3,2,0,0.01
26143,Roscommon,mi,13,22,9,1,3,2,0.01,0.02
31161,Sheridan,ne,29,43,14,1,3,2,0,0.02
53013,Columbia,wa,18,28,10,1,3,2,0,0
33001,Belknap,nh,12,22,10,1,3,2,0.01,0
42065,Jefferson,pa,12,24,12,1,3,2,0,0.02
42021,Cambria,pa,12,25,13,1,3,2,0,0.02
53039,Klickitat,wa,15,25,10,1,3,2,0.02,0.02
54101,Webster,wv,13,27,14,1,3,2,0.01,0.01
27029,Clearwater,mn,12,19,7,1,3,2,0.01,0.06
51197,Wythe,va,18,36,18,1,3,2,0,0.01
26031,Cheboygan,mi,10,18,8,1,3,2,0,0.02
33005,Cheshire,nh,12,23,11,1,3,2,0.01,0
35001,Bernalillo,nm,40,58,18,1,3,2,0,0.02
30065,Musselshell,mt,23,36,13,1,3,2,0,0
31013,Box Butte,ne,27,42,15,1,3,2,0,0.01
32027,Pershing,nv,34,49,15,1,3,2,0,0
54077,Preston,wv,11,24,13,1,3,2,0.02,0.01
27007,Beltrami,mn,12,18,6,1,3,2,0.03,0.07
47171,Unicoi,tn,17,33,16,1,3,2,0,0.01
41071,Yamhill,or,12,21,9,1,3,2,0,0
33019,Sullivan,nh,11,21,10,1,3,2,0.01,0.01
8087,Morgan,co,35,52,17,1,3,2,0,0
8063,Kit Carson,co,37,53,16,1,3,2,0.01,0
32019,Lyon,nv,37,54,17,1,3,2,0,0
30111,Yellowstone,mt,26,40,14,1,3,2,0,0
41067,Washington,or,10,18,8,1,3,2,0,0.01
37099,Jackson,nc,18,35,17,1,4,3,0.01,0.04
41055,Sherman,or,19,30,11,1,4,3,0.02,0.01
32001,Churchill,nv,42,58,16,1,4,3,0,0
6069,San Benito,ca,22,34,12,1,4,3,0.02,0
54067,Nicholas,wv,16,32,16,1,4,3,0.01,0.03
51195,Wise,va,20,39,19,1,4,3,0.01,0.02
35061,Valencia,nm,53,74,21,1,4,3,0,0.03
16053,Jerome,id,31,46,15,1,4,3,0,0
8075,Logan,co,37,52,15,1,4,3,0.01,0
32021,Mineral,nv,46,62,16,1,4,3,0,0
31157,Scotts Bluff,ne,33,49,16,1,4,3,0,0
37113,Macon,nc,22,41,19,1,5,4,0.01,0.03
8009,Baca,co,47,65,18,1,5,4,0.01,0.01
8017,Cheyenne,co,44,61,17,1,5,4,0.01,0.01
37173,Swain,nc,27,48,21,1,6,5,0.01,0.03
48111,Dallam,tx,50,69,19,1,6,5,0,0.01
48205,Hartley,tx,54,73,19,1,7,6,0,0.01
48359,Oldham,tx,52,72,20,1,7,6,0.01,0.02
8013,Boulder,co,17,32,15,0,1,1,0,0
8029,Delta,co,23,38,15,0,1,1,0,0
30029,Flathead,mt,6,14,8,0,1,1,0,0
23013,Knox,me,2,7,5,0,1,1,0,0
23015,Lincoln,me,3,9,6,0,1,1,0,0
37199,Yancey,nc,9,21,12,0,1,1,0,0.01
49001,Beaver,ut,16,30,14,0,1,1,0.01,0
41035,Klamath,or,9,18,9,0,1,1,0,0
25001,Barnstable,ma,4,11,7,0,1,1,0.03,0.05
26033,Chippewa,mi,4,9,5,0,1,1,0.03,0.02
26097,Mackinac,mi,3,7,4,0,1,1,0,0.01
16059,Lemhi,id,8,15,7,0,1,1,0,0
49029,Morgan,ut,10,21,11,0,1,1,0,0
53015,Cowlitz,wa,6,11,5,0,1,1,0,0.01
53037,Kittitas,wa,9,16,7,0,1,1,0,0
23023,Sagadahoc,me,5,12,7,0,1,1,0,0
30013,Cascade,mt,12,22,10,0,1,1,0,0
30027,Fergus,mt,12,20,8,0,1,1,0,0.01
30073,Pondera,mt,8,15,7,0,1,1,0,0
33007,Coos,nh,4,9,5,0,1,1,0,0
4005,Coconino,az,12,20,8,0,1,1,0.01,0.02
35045,San Juan,nm,30,48,18,0,1,1,0,0
36025,Delaware,ny,6,14,8,0,1,1,0,0
37009,Ashe,nc,6,17,11,0,1,1,0,0.01
49047,Uintah,ut,22,38,16,0,1,1,0.01,0.02
51091,Highland,va,8,18,10,0,1,1,0.02,0.04
53053,Pierce,wa,3,8,5,0,1,1,0,0
54093,Tucker,wv,6,14,8,0,1,1,0.01,0.01
23007,Franklin,me,4,10,6,0,1,1,0,0
41017,Deschutes,or,10,19,9,0,1,1,0,0
41023,Grant,or,12,21,9,0,1,1,0,0.01
47091,Johnson,tn,9,22,13,0,1,1,0,0.01
56003,Big Horn,wy,21,35,14,0,1,1,0,0
56031,Platte,wy,21,37,16,0,1,1,0,0
4001,Apache,az,12,23,11,0,1,1,0,0.01
49007,Carbon,ut,14,27,13,0,1,1,0,0
53045,Mason,wa,4,9,5,0,1,1,0,0
23003,Aroostook,me,3,8,5,0,1,1,0.01,0
30053,Lincoln,mt,9,16,7,0,1,1,0,0
30009,Carbon,mt,9,17,8,0,1,1,0,0
36009,Cattaraugus,ny,7,15,8,0,1,1,0,0.01
6053,Monterey,ca,5,7,2,0,1,1,0,0.01
53033,King,wa,3,7,4,0,1,1,0,0
24023,Garrett,md,6,15,9,0,1,1,0,0.01
49005,Cache,ut,15,28,13,0,1,1,0,0
49023,Juab,ut,19,32,13,0,1,1,0,0.01
53019,Ferry,wa,9,16,7,0,1,1,0,0
56033,Sheridan,wy,17,30,13,0,1,1,0,0
30061,Mineral,mt,10,18,8,0,1,1,0,0.01
53067,Thurston,wa,5,10,5,0,1,1,0,0.01
16031,Cassia,id,15,29,14,0,1,1,0,0
32031,Washoe,nv,21,35,14,0,1,1,0,0
32011,Eureka,nv,25,38,13,0,1,1,0.01,0
49017,Garfield,ut,11,17,6,0,1,1,0,0.02
6041,Marin,ca,3,7,4,0,1,1,0,0
8001,Adams,co,22,39,17,0,1,1,0,0
49037,San Juan,ut,17,28,11,0,1,1,0,0.02
8073,Lincoln,co,22,37,15,0,1,1,0,0
16009,Benewah,id,9,18,9,0,1,1,0,0
16019,Bonneville,id,11,23,12,0,1,1,0.01,0
16021,Boundary,id,10,18,8,0,1,1,0,0
51720,Norton,va,6,16,10,0,1,1,0,0.01
53051,Pend Oreille,wa,10,19,9,0,1,1,0,0
53059,Skamania,wa,7,14,7,0,1,1,0,0.01
30101,Toole,mt,11,20,9,0,1,1,0,0
42083,McKean,pa,6,14,8,0,1,1,0,0.01
41025,Harney,or,11,22,11,0,1,1,0,0.01
30095,Stillwater,mt,14,24,10,0,1,1,0,0
32009,Esmeralda,nv,21,36,15,0,1,1,0,0.01
37189,Watauga,nc,6,15,9,0,1,1,0,0.01
50009,Essex,vt,5,11,6,0,1,1,0,0
56005,Campbell,wy,15,28,13,0,1,1,0,0
50019,Orleans,vt,5,11,6,0,1,1,0,0
42105,Potter,pa,6,14,8,0,1,1,0,0
23021,Piscataquis,me,4,8,4,0,1,1,0,0
53035,Kitsap,wa,2,6,4,0,1,1,0,0
35057,Torrance,nm,11,25,14,0,1,1,0,0.01
50003,Bennington,vt,7,14,7,0,1,1,0.01,0
42047,Elk,pa,7,16,9,0,1,1,0,0
8014,Broomfield,co,21,36,15,0,1,1,0,0
42123,Warren,pa,9,18,9,0,1,1,0,0.01
6003,Alpine,ca,1,3,2,0,0,0,0,0
30037,Golden Valley,mt,15,26,11,0,1,1,0,0
30051,Liberty,mt,13,22,9,0,1,1,0,0
16071,Oneida,id,14,26,12,0,1,1,0,0
35006,Cibola,nm,10,20,10,0,1,1,0,0.02
30097,Sweet Grass,mt,10,18,8,0,1,1,0,0
6087,Santa Cruz,ca,6,10,4,0,1,1,0,0
35027,Lincoln,nm,8,17,9,0,1,1,0.01,0.11
16055,Kootenai,id,11,20,9,0,1,1,0,0
56011,Crook,wy,16,28,12,0,1,1,0,0.01
56017,Hot Springs,wy,24,39,15,0,1,1,0,0
56027,Niobrara,wy,17,31,14,0,1,1,0,0
36041,Hamilton,ny,4,10,6,0,1,1,0,0
23009,Hancock,me,4,10,6,0,1,1,0.01,0
8049,Grand,co,0,0,0,0,0,0,0,0
50015,Lamoille,vt,6,12,6,0,1,1,0,0
8083,Montezuma,co,8,17,9,0,0,0,0,0.01
8091,Ouray,co,0,1,1,0,0,0,0,0
16011,Bingham,id,14,27,13,0,1,1,0.01,0
31007,Banner,ne,22,37,15,0,1,1,0,0
41063,Wallowa,or,6,12,6,0,1,1,0,0
35059,Union,nm,21,37,16,0,1,1,0.01,0
23029,Washington,me,3,7,4,0,1,1,0,0.01
50023,Washington,vt,6,13,7,0,1,1,0,0
56043,Washakie,wy,26,41,15,0,1,1,0,0
53069,Wahkiakum,wa,2,5,3,0,1,1,0,0.01
41013,Crook,or,13,23,10,0,1,1,0,0
16017,Bonner,id,7,14,7,0,1,1,0,0
46081,Lawrence,sd,9,17,8,0,1,1,0,0
36003,Allegany,ny,7,15,8,0,1,1,0.01,0
31105,Kimball,ne,19,33,14,0,1,1,0,0
16077,Power,id,16,29,13,0,1,1,0,0
54075,Pocahontas,wv,6,17,11,0,1,1,0.02,0.04
50005,Caledonia,vt,6,14,8,0,1,1,0,0
30063,Missoula,mt,9,17,8,0,1,1,0,0
30047,Lake,mt,8,16,8,0,1,1,0,0
16057,Latah,id,12,22,10,0,1,1,0,0
26083,Keweenaw,mi,3,6,3,0,1,1,0,0.01
49013,Duchesne,ut,10,19,9,0,1,1,0.01,0.02
16023,Butte,id,8,17,9,0,0,0,0,0
16025,Camas,id,6,14,8,0,0,0,0,0
16037,Custer,id,4,10,6,0,0,0,0,0
41061,Union,or,15,26,11,0,2,2,0,0
16043,Fremont,id,2,6,4,0,0,0,0,0
42111,Somerset,pa,8,18,10,0,2,2,0,0.05
16085,Valley,id,3,8,5,0,0,0,0,0
51185,Tazewell,va,11,25,14,0,2,2,0,0.01
42127,Wayne,pa,8,17,9,0,2,2,0,0
50017,Orange,vt,7,15,8,0,2,2,0,0.01
54081,Raleigh,wv,12,27,15,0,2,2,0.01,0.02
42049,Erie,pa,8,18,10,0,2,2,0,0
23025,Somerset,me,7,14,7,0,2,2,0,0
54083,Randolph,wv,8,19,11,0,2,2,0.02,0.01
30023,Deer Lodge,mt,1,3,2,0,0,0,0,0
30039,Granite,mt,2,4,2,0,0,0,0,0
30057,Madison,mt,2,6,4,0,0,0,0,0
16041,Franklin,id,17,31,14,0,2,2,0,0
30077,Powell,mt,2,6,4,0,0,0,0,0
53075,Whitman,wa,12,22,10,0,2,2,0,0
49057,Weber,ut,20,34,14,0,2,2,0.01,0.02
32013,Humboldt,nv,27,43,16,0,2,2,0,0.01
37121,Mitchell,nc,12,25,13,0,2,2,0.01,0.02
35047,San Miguel,nm,16,26,10,0,2,2,0.01,0.01
37087,Haywood,nc,13,28,15,0,2,2,0,0.01
54055,Mercer,wv,12,27,15,0,2,2,0,0.01
35007,Colfax,nm,3,8,5,0,0,0,0,0
36049,Lewis,ny,7,15,8,0,2,2,0.01,0.01
37005,Alleghany,nc,12,27,15,0,2,2,0,0.02
31165,Sioux,ne,22,37,15,0,2,2,0,0
23005,Cumberland,me,7,15,8,0,2,2,0.01,0
51021,Bland,va,11,26,15,0,2,2,0,0.01
8123,Weld,co,27,44,17,0,2,2,0,0
51640,Galax,va,14,30,16,0,2,2,0,0.01
51077,Grayson,va,11,26,15,0,2,2,0,0.01
16067,Minidoka,id,20,36,16,0,2,2,0,0
16005,Bannock,id,17,30,13,0,2,2,0.01,0
35017,Grant,nm,21,39,18,0,3,3,0.01,0.13
8101,Pueblo,co,35,52,17,0,3,3,0,0.01
51173,Smyth,va,16,32,16,0,3,3,0,0.01
49043,Summit,ut,1,4,3,0,0,0,0,0
53009,Clallam,wa,1,1,0,0,0,0,0,0
53031,Jefferson,wa,1,3,2,0,0,0,0,0
6051,Mono,ca,4,6,2,0,0,0,0,0
25007,Dukes,ma,3,12,9,0,0,0,0,0
30001,Beaverhead,mt,2,5,3,0,0,0,0,0
30031,Gallatin,mt,6,13,7,0,0,0,0,0
30045,Judith Basin,mt,5,10,5,0,0,0,0,0
30049,Lewis and Clark,mt,7,15,8,0,0,0,0,0
30059,Meagher,mt,2,4,2,0,0,0,0,0
30099,Teton,mt,7,14,7,0,0,0,0,0
6083,Santa Barbara,ca,3,6,3,0,0,0,0,0.01
8019,Clear Creek,co,0,0,0,0,0,0,0,0
8023,Costilla,co,0,1,1,0,0,0,0,0
8031,Denver,co,17,32,15,0,0,0,0,0
8037,Eagle,co,0,2,2,0,0,0,0,0
8055,Huerfano,co,5,13,8,0,0,0,0,0
56029,Park,wy,8,16,8,0,0,0,0,0
27031,Cook,mn,2,3,1,0,0,0,0.03,0.02
35039,Rio Arriba,nm,7,15,8,0,0,0,0,0
35055,Taos,nm,1,4,3,0,0,0,0,0
49033,Rich,ut,2,7,5,0,0,0,0,0
49051,Wasatch,ut,5,13,8,0,0,0,0,0
53049,Pacific,wa,0,1,1,0,0,0,0,0.01
53061,Snohomish,wa,1,5,4,0,0,0,0.01,0
53073,Whatcom,wa,1,3,2,0,0,0,0,0
8065,Lake,co,0,0,0,0,0,0,0,0
8071,Las Animas,co,8,17,9,0,0,0,0.01,0
8093,Park,co,0,0,0,0,0,0,0,0
8105,Rio Grande,co,0,0,0,0,0,0,0,0
8113,San Miguel,co,0,1,1,0,0,0,0,0
41007,Clatsop,or,0,1,1,0,0,0,0,0
8043,Fremont,co,16,28,12,0,0,0,0,0
8097,Pitkin,co,0,0,0,0,0,0,0,0
8035,Douglas,co,7,17,10,0,0,0,0,0
56013,Fremont,wy,9,21,12,0,0,0,0,0
56035,Sublette,wy,0,1,1,0,0,0,0,0
41015,Curry,or,1,1,0,0,0,0,0,0
8027,Custer,co,0,1,1,0,0,0,0,0
8051,Gunnison,co,0,0,0,0,0,0,0,0
6063,Plumas,ca,6,13,7,0,0,0,0,0
53027,Grays Harbor,wa,1,2,1,0,0,0,0,0
30043,Jefferson,mt,4,9,5,0,0,0,0,0
30007,Broadwater,mt,8,18,10,0,0,0,0,0
30093,Silver Bow,mt,1,4,3,0,0,0,0,0
8111,San Juan,co,0,0,0,0,0,0,0,0
16079,Shoshone,id,4,9,5,0,0,0,0,0
53057,Skagit,wa,0,1,1,0,0,0,0,0
6091,Sierra,ca,4,10,6,0,0,0,0,0
56039,Teton,wy,1,3,2,0,0,0,0,0
8005,Arapahoe,co,13,27,14,0,0,0,0,0
8033,Dolores,co,3,8,5,0,0,0,0,0.01
30035,Glacier,mt,2,5,3,0,0,0,0,0
32033,White Pine,nv,5,14,9,0,0,0,0,0
16007,Bear Lake,id,3,8,5,0,0,0,0,0
16013,Blaine,id,4,9,5,0,0,0,0,0
8069,Larimer,co,12,24,12,0,0,0,0,0
8117,Summit,co,0,0,0,0,0,0,0,0
16029,Caribou,id,5,11,6,0,0,0,0.01,0
53055,San Juan,wa,0,0,0,0,0,0,0,0
8021,Conejos,co,0,1,1,0,0,0,0,0
8039,Elbert,co,6,15,9,0,0,0,0,0
8059,Jefferson,co,13,25,12,0,0,0,0,0
6035,Lassen,ca,8,17,9,0,0,0,0,0
6075,San Francisco,ca,0,0,0,0,0,0,0,0
8003,Alamosa,co,0,1,1,0,0,0,0,0
8015,Chaffee,co,0,1,1,0,0,0,0,0
16051,Jefferson,id,9,21,12,0,0,0,0,0
16065,Madison,id,6,15,9,0,0,0,0,0
16033,Clark,id,4,10,6,0,0,0,0,0
30067,Park,mt,4,10,6,0,0,0,0,0
41011,Coos,or,0,1,1,0,0,0,0,0
49009,Daggett,ut,8,17,9,0,0,0,0,0
49021,Iron,ut,11,22,11,0,0,0,0.01,0
56041,Uinta,wy,1,2,1,0,0,0,0,0
56001,Albany,wy,0,1,1,0,0,0,0,0
32510,Carson City,nv,15,29,14,0,0,0,0,0
53029,Island,wa,0,1,1,0,0,0,0,0
25019,Nantucket,ma,0,1,1,0,0,0,0,0
8041,El Paso,co,4,12,8,0,0,0,0,0
8047,Gilpin,co,0,0,0,0,0,0,0,0
8103,Rio Blanco,co,10,19,9,0,0,0,0,0
8109,Saguache,co,0,1,1,0,0,0,0,0
8119,Teller,co,0,0,0,0,0,0,0,0
8081,Moffat,co,4,10,6,0,0,0,0,0
8085,Montrose,co,12,24,12,0,0,0,0,0.01
56019,Johnson,wy,10,20,10,0,0,0,0,0
49041,Sevier,ut,10,18,8,0,0,0,0,0
30107,Wheatland,mt,8,15,7,0,0,0,0,0
56037,Sweetwater,wy,2,7,5,0,0,0,0,0
41057,Tillamook,or,0,1,1,0,0,0,0,0
35028,Los Alamos,nm,8,17,9,0,0,0,0,0
6049,Modoc,ca,7,15,8,0,0,0,0,0
56023,Lincoln,wy,1,3,2,0,0,0,0,0
56007,Carbon,wy,1,3,2,0,0,0,0,0
49031,Piute,ut,8,19,11,0,0,0,0,0
32029,Storey,nv,11,22,11,0,0,0,0,0
41037,Lake,or,7,16,9,0,0,0,0,0
16081,Teton,id,1,3,2,0,0,0,0,0
8007,Archuleta,co,1,2,1,0,0,0,0,0
32005,Douglas,nv,14,26,12,0,0,0,0,0
41041,Lincoln,or,0,1,1,0,0,0,0,0.01
56009,Converse,wy,14,26,12,0,0,0,0,0
8107,Routt,co,0,1,1,0,0,0,0,0
35031,McKinley,nm,4,12,8,0,0,0,0,0
56025,Natrona,wy,11,23,12,0,0,0,0,0
56021,Laramie,wy,4,12,8,0,0,0,0,0
35049,Santa Fe,nm,5,13,8,0,0,0,0,0
8045,Garfield,co,8,18,10,0,0,0,0,0
32007,Elko,nv,14,28,14,0,0,0,0,0
8067,La Plata,co,2,6,4,0,0,0,0,0
49039,Sanpete,ut,6,12,6,0,0,0,0,0
6015,Del Norte,ca,0,1,1,0,0,0,0,0
8079,Mineral,co,0,0,0,0,0,0,0,0
37011,Avery,nc,3,9,6,0,0,0,0.02,0.02
11001,District of Columbia,,,,,,,,0.11,0.38
48083,Coleman,,,,,,,,0.06,0.1
21195,Pike,,,,,,,,0.09,0.24
21237,Wolfe,,,,,,,,0.02,0.1
48289,Leon,,,,,,,,0.26,1.32
51051,Dickenson,,,,,,,,0.01,0.03
21085,Grayson,,,,,,,,0.14,0.56
21109,Jackson,,,,,,,,0.02,0.11
21119,Knott,,,,,,,,0.03,0.09
21139,Livingston,,,,,,,,0.41,1.82
21051,Clay,,,,,,,,0.02,0.09
21165,Menifee,,,,,,,,0.03,0.13
46117,Stanley,,,,,,,,0.04,0.06
46041,Dewey,,,,,,,,0.04,0.06
22091,St. Helena,,,,,,,,0.18,0.48
35033,Mora,,,,,,,,0,0
21123,Larue,,,,,,,,0.09,0.3
22065,Madison,,,,,,,,0.43,1.56
22127,Winn,,,,,,,,0.45,1.61
51105,Lee,,,,,,,,0.01,0.04
26013,Baraga,,,,,,,,0.02,0.04
21203,Rockcastle,,,,,,,,0.03,0.13
8121,Washington,,,,,,,,0,0
48045,Briscoe,,,,,,,,0.02,0.16
8053,Hinsdale,,,,,,,,0,0
46059,Hand,,,,,,,,0.06,0.11
8011,Bent,,,,,,,,0.01,0
26131,Ontonagon,,,,,,,,0.02,0.03
21103,Henry,,,,,,,,0.11,0.35
35003,Catron,,,,,,,,0,0.01
35037,Quay,,,,,,,,0.01,0.02
21013,Bell,,,,,,,,0.01,0.07
26153,Schoolcraft,,,,,,,,0.05,0.12
46107,Potter,,,,,,,,0.05,0.1
21129,Lee,,,,,,,,0.02,0.11
21169,Metcalfe,,,,,,,,0.08,0.36
51045,Craig,,,,,,,,0.02,0.11
8061,Kiowa,,,,,,,,0,0
21053,Clinton,,,,,,,,0.08,0.28
8025,Crowley,,,,,,,,0,0.01
46119,Sully,,,,,,,,0.04,0.1
46137,Ziebach,,,,,,,,0.03,0.03
8057,Jackson,,,,,,,,0,0